a_name,forward_fw_inputsize,forward_fw_mean_time,forward_fw_stdvar_time,forward_op_after_byte_memory,forward_op_before_byte_memory,forward_op_used_byte_memory
split-41,48136,12792.701909537805,0.0,386093056,385650688,442368
strided_slice-45,38536,9457.218637025848,0.0,386273280,386273280,0
split-54,0,8944.52687245118,0.0,386285568,386281472,4096
split-64,0,8146.084838593245,0.0,386285568,386285568,0
split-76,0,30.50736356576148,0.0,386482176,386478080,4096
strided_slice-97,38536,9383.418615124787,0.0,386486272,386482176,4096
strided_slice-198,38536,9447.350890782338,0.0,386486272,386486272,0
split-207,0,8146.610090572779,0.0,386498560,386486272,12288
split-217,0,8184.712346982276,0.0,386498560,386498560,0
split-229,0,28.659306098691395,0.0,386506752,386506752,0
strided_slice-250,38536,9447.597447815431,0.0,386506752,386506752,0
squeeze-39,64,6.38274999343095,0.0,386506752,386506752,0
squeeze-112,64,6.411319030573045,0.0,386510848,386510848,0
squeeze-135,64,6.36680575725815,0.0,386510848,386510848,0
squeeze-158,64,6.361117667618252,0.0,386514944,386514944,0
squeeze-181,64,6.342075647050524,0.0,386514944,386514944,0
split-44,64,10016.819643068196,0.0,386519040,386514944,4096
squeeze-52,64,6.3644337181748485,0.0,386523136,386519040,4096
squeeze-62,64,6.3857153550464325,0.0,386527232,386527232,0
split-74,64,35.50515267110564,0.0,386531328,386527232,4096
split-96,64,10063.285491169758,0.0,386535424,386535424,0
split-197,64,10048.523244576263,0.0,386535424,386535424,0
squeeze-205,64,6.3433850549196045,0.0,386539520,386539520,0
squeeze-215,64,6.429552316083959,0.0,386539520,386539520,0
split-227,64,35.08568769862497,0.0,386543616,386543616,0
split-249,64,10081.851748276042,0.0,386547712,386543616,4096
squeeze-42,64,6.3972676177553645,0.0,386547712,386547712,0
split-51,64,9699.164104096015,0.0,386686976,386686976,0
split-61,64,9687.712338605423,0.0,387227648,387190784,36864
squeeze-72,64,6.37659089178793,0.0,387239936,387239936,0
squeeze-84,64,6.36925352583779,0.0,387239936,387239936,0
squeeze-94,64,6.363479747858914,0.0,387239936,387239936,0
squeeze-195,64,6.3697541727990385,0.0,387239936,387239936,0
split-204,64,9719.113731533282,0.0,387289088,387272704,16384
split-214,64,9752.913271053956,0.0,387309568,387301376,8192
squeeze-225,64,6.375223162342632,0.0,387313664,387313664,0
squeeze-237,64,6.387381630626972,0.0,387317760,387317760,0
squeeze-247,64,6.359757070806152,0.0,387317760,387317760,0
tuple-38,128,6.188640279077222,0.0,387321856,387321856,0
tuple-49,256,8.391977106163798,0.0,387321856,387321856,0
tuple-59,256,7.83351168735554,0.0,387321856,387321856,0
split-71,64,8277.379150816185,0.0,387330048,387325952,4096
split-83,64,8279.182258636916,0.0,387330048,387330048,0
tuple-202,256,7.840491895450966,0.0,387330048,387330048,0
tuple-212,256,7.838937035699593,0.0,387330048,387330048,0
split-224,64,8281.349241645836,0.0,387338240,387334144,4096
split-236,64,8266.508300728477,0.0,387342336,387338240,4096
concatenate-37,128,10423.859846132618,0.0,387346432,387346432,0
concatenate-48,256,9609.779032153716,0.0,387411968,387411968,0
concatenate-58,256,8530.623663324754,0.0,387411968,387411968,0
tuple-69,256,7.83479222852162,0.0,387411968,387411968,0
tuple-81,256,7.833466317092751,0.0,387411968,387411968,0
concatenate-201,256,8562.327069112273,0.0,387416064,387416064,0
concatenate-211,256,8652.481298020151,0.0,387416064,387416064,0
tuple-222,256,7.834654605975425,0.0,387420160,387420160,0
tuple-234,256,7.833532413004747,0.0,387420160,387420160,0
tuple-47,128,6.355024937863964,0.0,387420160,387420160,0
tuple-115,128,6.199474942681348,0.0,387420160,387420160,0
tuple-138,128,5.955752295463703,0.0,387420160,387420160,0
tuple-161,128,6.120032957474081,0.0,387420160,387420160,0
tuple-184,128,6.123889967804428,0.0,387420160,387420160,0
concatenate-68,256,9546.060971541934,0.0,387444736,387444736,0
concatenate-80,256,9482.710480295566,0.0,387444736,387444736,0
tuple-200,128,6.560751777426948,0.0,387444736,387444736,0
tuple-268,128,6.261211449266759,0.0,387444736,387444736,0
tuple-291,128,6.086437661016613,0.0,387444736,387444736,0
tuple-314,128,6.153727543874815,0.0,387444736,387444736,0
tuple-337,128,6.15105463040722,0.0,387444736,387444736,0
concatenate-221,256,9555.063261391715,0.0,387452928,387452928,0
concatenate-233,256,9487.422648427582,0.0,387452928,387452928,0
concatenate-46,128,9788.56715892546,0.0,387452928,387452928,0
concatenate-114,128,9806.012448486086,0.0,387452928,387452928,0
concatenate-137,128,9810.773195674703,0.0,387457024,387457024,0
concatenate-160,128,9874.063476874002,0.0,387457024,387457024,0
concatenate-183,128,9734.750507410756,0.0,387457024,387457024,0
concatenate-199,128,9634.80171548499,0.0,387457024,387457024,0
concatenate-267,128,9664.663109610041,0.0,387461120,387461120,0
concatenate-290,128,10331.567697608512,0.0,387465216,387465216,0
concatenate-313,128,9600.161825208828,0.0,387469312,387469312,0
concatenate-336,128,9600.512539745254,0.0,387469312,387469312,0
nn.dense-36,128,18493.72180129537,0.0,387887104,387866624,20480
add-35,128,9550.948090107737,0.0,387887104,387887104,0
add-34,128,9551.364582442333,0.0,387891200,387891200,0
split-33,64,13681.466666666667,0.0,387895296,387895296,0
sigmoid-31,64,11368.76499673274,0.0,387964928,387964928,0
sigmoid-92,64,11133.229173173017,0.0,387969024,387969024,0
sigmoid-99,64,11197.25931031416,0.0,387969024,387969024,0
tanh-101,64,12524.360321240136,0.0,387973120,387969024,4096
multiply-91,128,10206.772315278078,0.0,387977216,387973120,4096
multiply-98,128,10155.664921372409,0.0,387977216,387977216,0
add-90,128,10182.879833807277,0.0,387985408,387981312,4096
tanh-89,64,12389.566298472386,0.0,387985408,387985408,0
multiply-30,128,10174.606451363823,0.0,387985408,387985408,0
tuple-111,128,6.118775554229885,0.0,387989504,387989504,0
concatenate-110,128,10402.338354993928,0.0,387989504,387989504,0
nn.dense-109,128,18755.850945401657,0.0,388046848,387989504,57344
add-108,128,9550.776866975335,0.0,388108288,388108288,0
add-107,128,10664.640333298175,0.0,388108288,388108288,0
split-106,64,13703.676284941388,0.0,388395008,388313088,81920
sigmoid-104,64,9911.867814940919,0.0,388395008,388395008,0
sigmoid-119,64,10021.671502859153,0.0,388395008,388395008,0
sigmoid-122,64,10611.65627297231,0.0,388395008,388395008,0
tanh-124,64,11361.19143239625,0.0,388395008,388395008,0
multiply-118,128,9466.13130570293,0.0,388395008,388395008,0
multiply-121,128,9503.601713102766,0.0,388395008,388395008,0
add-117,128,9550.214874773832,0.0,388395008,388395008,0
tanh-116,64,11432.398016442647,0.0,388395008,388395008,0
multiply-103,128,9434.308898707646,0.0,388395008,388395008,0
tuple-134,128,6.176304957034019,0.0,388395008,388395008,0
concatenate-133,128,9583.291741813004,0.0,388395008,388395008,0
nn.dense-132,128,18062.346029713117,0.0,388579328,388468736,110592
add-131,128,9170.126333308117,0.0,388587520,388587520,0
add-130,128,9194.677265753133,0.0,388587520,388587520,0
split-129,64,13012.092783026534,0.0,388972544,388894720,77824
sigmoid-127,64,10149.452357805694,0.0,389017600,389017600,0
sigmoid-142,64,10096.054042240368,0.0,389017600,389017600,0
sigmoid-145,64,10245.194120846094,0.0,389017600,389017600,0
tanh-147,64,10674.764458831572,0.0,389021696,389017600,4096
multiply-141,128,9570.621090475572,0.0,389025792,389021696,4096
multiply-144,128,9515.686460351259,0.0,389025792,389025792,0
add-140,128,9551.619691398084,0.0,389062656,389062656,0
tanh-139,64,10762.258724314373,0.0,389062656,389062656,0
multiply-126,128,9473.018256743668,0.0,389062656,389062656,0
tuple-157,128,6.753727555242121,0.0,389066752,389066752,0
concatenate-156,128,9612.771404331943,0.0,389070848,389070848,0
nn.dense-155,128,17782.912991755657,0.0,389201920,389124096,77824
add-154,128,9079.055883983005,0.0,389341184,389337088,4096
add-153,128,9081.251105866726,0.0,389341184,389341184,0
split-152,64,13064.976148620788,0.0,389677056,389591040,86016
sigmoid-150,64,10037.17480447729,0.0,389677056,389677056,0
sigmoid-165,64,9990.990964563762,0.0,389681152,389681152,0
sigmoid-168,64,10023.594482579976,0.0,389685248,389681152,4096
tanh-170,64,10840.59339525284,0.0,389685248,389685248,0
multiply-164,128,9505.553385907768,0.0,389689344,389689344,0
multiply-167,128,9538.851587400512,0.0,389689344,389689344,0
add-163,128,9541.860134558892,0.0,389689344,389689344,0
tanh-162,64,11225.669320923082,0.0,389869568,389836800,32768
multiply-149,128,9447.823831263475,0.0,389869568,389869568,0
tuple-180,128,6.523208092606298,0.0,389877760,389877760,0
concatenate-179,128,9528.995294956942,0.0,389877760,389877760,0
nn.dense-178,128,17941.356546033734,0.0,390029312,389922816,106496
add-177,128,9094.070713519586,0.0,390041600,390041600,0
add-176,128,9104.939387857501,0.0,390045696,390045696,0
split-175,64,13010.908160610528,0.0,390434816,390348800,86016
sigmoid-173,64,10134.205545671824,0.0,390443008,390443008,0
sigmoid-188,64,10028.647089554292,0.0,390443008,390443008,0
sigmoid-191,64,10018.314251978836,0.0,390447104,390447104,0
tanh-193,64,11624.593734200385,0.0,390451200,390451200,0
multiply-187,128,9480.078106866538,0.0,390451200,390451200,0
multiply-190,128,9475.14948526301,0.0,390459392,390459392,0
add-186,128,9454.063581644745,0.0,390459392,390459392,0
tanh-185,64,11442.151713395637,0.0,390459392,390459392,0
expand_dims-354,64,7.587769982533442,0.0,390463488,390459392,4096
multiply-172,128,9496.7076578626,0.0,390475776,390471680,4096
tuple-29,320,8.47110241685263,0.0,390475776,390475776,0
expand_dims-350,64,6.310408628949654,0.0,390475776,390475776,0
stack-28,320,9763.89578618658,0.0,391421952,391323648,98304
expand_dims-27,64,6.376006658128229,0.0,391487488,391483392,4096
squeeze-26,64,6.376284324527161,0.0,391491584,391487488,4096
split-25,64,13772.29222972973,0.0,391761920,391659520,102400
squeeze-23,64,6.347016305859534,0.0,391761920,391761920,0
squeeze-265,64,6.365645837290949,0.0,391761920,391761920,0
squeeze-288,64,6.364341359338268,0.0,391761920,391761920,0
squeeze-311,64,6.378856424509322,0.0,391766016,391761920,4096
squeeze-334,64,6.369500028175063,0.0,391770112,391770112,0
tuple-22,128,6.117992379037971,0.0,391770112,391770112,0
concatenate-21,128,9658.859718255548,0.0,391770112,391770112,0
nn.dense-20,128,20747.50403665721,0.0,391782400,391770112,12288
add-19,128,9114.199043474213,0.0,391786496,391786496,0
add-18,128,9248.74975650229,0.0,391786496,391786496,0
split-17,64,13065.497449780289,0.0,391794688,391790592,4096
sigmoid-15,64,9886.07316166711,0.0,391794688,391794688,0
sigmoid-245,64,9825.745881514336,0.0,391794688,391794688,0
sigmoid-252,64,10039.252468302497,0.0,391794688,391794688,0
tanh-254,64,11781.677337240448,0.0,391794688,391794688,0
multiply-244,128,9455.021519815447,0.0,391794688,391794688,0
multiply-251,128,9501.356055125198,0.0,391794688,391794688,0
add-243,128,9461.482608695651,0.0,391794688,391794688,0
tanh-242,64,11637.942561342965,0.0,391794688,391794688,0
multiply-14,128,9506.462451467045,0.0,391794688,391794688,0
tuple-264,128,6.115501589427683,0.0,391798784,391798784,0
concatenate-263,128,9623.109029907977,0.0,391802880,391802880,0
nn.dense-262,128,21820.919491265708,0.0,391954432,391852032,102400
add-261,128,9086.596116671679,0.0,392007680,392007680,0
add-260,128,9251.700215608911,0.0,392011776,392011776,0
split-259,64,13041.150374007146,0.0,392351744,392265728,86016
sigmoid-257,64,9897.23927712841,0.0,392355840,392355840,0
sigmoid-272,64,10066.213488119427,0.0,392355840,392355840,0
sigmoid-275,64,9929.207954486857,0.0,392355840,392355840,0
tanh-277,64,11425.990167158308,0.0,392355840,392355840,0
multiply-271,128,9485.173372502937,0.0,392355840,392355840,0
multiply-274,128,9494.69495283091,0.0,392364032,392355840,8192
add-270,128,9479.335960892147,0.0,392364032,392364032,0
tanh-269,64,11522.547248159455,0.0,392364032,392364032,0
multiply-256,128,9429.557386934674,0.0,392368128,392364032,4096
tuple-287,128,6.117037877673379,0.0,392372224,392372224,0
concatenate-286,128,9706.248923920743,0.0,392380416,392372224,8192
nn.dense-285,128,20460.343529261358,0.0,392527872,392454144,73728
add-284,128,9078.12729427221,0.0,392544256,392540160,4096
add-283,128,9074.860505615314,0.0,392544256,392544256,0
split-282,64,13042.772046472564,0.0,392949760,392863744,86016
sigmoid-280,64,10039.508845036562,0.0,392962048,392962048,0
sigmoid-295,64,9989.63076644168,0.0,392966144,392962048,4096
sigmoid-298,64,9963.790249626223,0.0,392966144,392966144,0
tanh-300,64,10649.749007389435,0.0,392966144,392966144,0
multiply-294,128,9465.970539501981,0.0,392970240,392970240,0
multiply-297,128,9523.301664867322,0.0,392974336,392970240,4096
add-293,128,9462.052352623039,0.0,392974336,392974336,0
tanh-292,64,10912.320494300386,0.0,392978432,392974336,4096
multiply-279,128,9445.740733078168,0.0,392982528,392978432,4096
tuple-310,128,6.129066806448989,0.0,392982528,392982528,0
concatenate-309,128,9627.874979732847,0.0,392994816,392986624,8192
nn.dense-308,128,21498.921526355505,0.0,393134080,393134080,0
add-307,128,9063.166765543428,0.0,393183232,393138176,45056
add-306,128,9066.774039165894,0.0,393256960,393183232,73728
split-305,64,13024.40868776679,0.0,393531392,393449472,81920
sigmoid-303,64,10088.847785676606,0.0,393543680,393543680,0
sigmoid-318,64,10000.387337264938,0.0,393547776,393543680,4096
sigmoid-321,64,10010.172777604976,0.0,393551872,393551872,0
tanh-323,64,10593.070815511031,0.0,393551872,393551872,0
multiply-317,128,9460.437234042553,0.0,393568256,393564160,4096
multiply-320,128,9465.025418445159,0.0,393568256,393568256,0
add-316,128,9431.475387483171,0.0,393576448,393572352,4096
tanh-315,64,11142.418944944526,0.0,393580544,393580544,0
multiply-302,128,9455.45304191573,0.0,393580544,393580544,0
tuple-333,128,6.1131039250682875,0.0,393584640,393584640,0
concatenate-332,128,9609.865683340458,0.0,393592832,393592832,0
nn.dense-331,128,19763.900565945805,0.0,393752576,393650176,102400
add-330,128,9074.741966767959,0.0,393818112,393793536,24576
add-329,128,9075.281173935091,0.0,393887744,393818112,69632
split-328,64,13022.184438277314,0.0,394162176,394076160,86016
sigmoid-326,64,10058.063611121826,0.0,394190848,394190848,0
sigmoid-341,64,9986.005086696618,0.0,394190848,394190848,0
sigmoid-344,64,9987.961466834638,0.0,394194944,394190848,4096
tanh-346,64,10665.919019850046,0.0,394199040,394199040,0
multiply-340,128,9548.361264150943,0.0,394199040,394199040,0
multiply-343,128,9484.56320592327,0.0,394199040,394199040,0
add-339,128,9519.190471683825,0.0,394199040,394199040,0
tanh-338,64,11494.807123153842,0.0,394199040,394199040,0
expand_dims-355,64,7.04678035400304,0.0,394199040,394199040,0
multiply-325,128,9523.938032884067,0.0,394199040,394199040,0
tuple-353,128,6.095708021856627,0.0,394199040,394199040,0
tuple-13,320,8.464660994301477,0.0,394199040,394199040,0
expand_dims-351,64,6.386842087210774,0.0,394240000,394240000,0
concatenate-352,128,9115.626201527515,0.0,394256384,394240000,16384
stack-12,320,9863.457957828094,0.0,395177984,395083776,94208
tuple-349,128,6.101048135852579,0.0,395190272,395190272,0
expand_dims-11,64,6.35726953100316,0.0,395190272,395190272,0
concatenate-348,128,9164.646340767782,0.0,395190272,395190272,0
squeeze-10,64,6.38058373075565,0.0,395190272,395190272,0
tuple-9,192,6.944447377697181,0.0,395190272,395190272,0
