a_name,forward_fw_inputsize,forward_fw_mean_time,forward_fw_stdvar_time,forward_op_after_byte_memory,forward_op_before_byte_memory,forward_op_used_byte_memory
split-117,4928,14389.585544952011,0.0,1182449664,1181913088,536576
strided_slice-121,2048,6342.441804149481,0.0,1182609408,1182572544,36864
split-130,0,6773.31739702875,0.0,1182617600,1182572544,45056
split-140,0,6522.339420451163,0.0,1182625792,1182572544,53248
split-152,0,30.50135424194584,0.0,1182756864,1182752768,4096
strided_slice-173,2048,6244.55402384966,0.0,1182760960,1182760960,0
strided_slice-389,2048,6307.574152807303,0.0,1182760960,1182760960,0
split-398,0,6457.292922793387,0.0,1182769152,1182760960,8192
split-408,0,6529.165955907059,0.0,1182769152,1182769152,0
split-420,0,32.10069499987783,0.0,1182777344,1182769152,8192
strided_slice-441,2048,6267.824555049022,0.0,1182777344,1182777344,0
strided_slice-657,2048,6248.231763088842,0.0,1182777344,1182777344,0
split-666,0,6439.402012572603,0.0,1182781440,1182777344,4096
split-676,0,6438.403056420078,0.0,1182785536,1182785536,0
split-688,0,29.43852589860629,0.0,1182785536,1182785536,0
strided_slice-709,2048,6272.707261061501,0.0,1182785536,1182785536,0
strided_slice-925,2048,6262.07801253773,0.0,1182789632,1182789632,0
split-934,0,6448.64402784104,0.0,1182789632,1182789632,0
split-944,0,6430.9674761269125,0.0,1182801920,1182797824,4096
split-956,0,29.306232061966487,0.0,1182801920,1182801920,0
strided_slice-977,2048,6267.3976487379805,0.0,1182806016,1182806016,0
strided_slice-1193,2048,6270.8028189761435,0.0,1182806016,1182806016,0
split-1202,0,6562.992804545042,0.0,1182810112,1182806016,4096
split-1212,0,6502.1969579588895,0.0,1182814208,1182814208,0
split-1224,0,29.2411608200808,0.0,1182814208,1182814208,0
strided_slice-1245,2048,6275.568122933216,0.0,1182814208,1182814208,0
strided_slice-1461,2048,6271.987535463467,0.0,1182814208,1182814208,0
split-1470,0,6452.1966206107545,0.0,1182818304,1182814208,4096
split-1480,0,6492.499326512226,0.0,1182818304,1182818304,0
split-1492,0,30.7133221867901,0.0,1182818304,1182818304,0
strided_slice-1513,2048,6272.85354687137,0.0,1182818304,1182818304,0
squeeze-115,64,6.987301609702528,0.0,1182826496,1182818304,8192
squeeze-188,64,7.113543891290951,0.0,1182826496,1182826496,0
squeeze-211,64,7.008574250162584,0.0,1182826496,1182826496,0
squeeze-234,64,7.164502902502868,0.0,1182826496,1182826496,0
squeeze-257,64,7.039298235476268,0.0,1182830592,1182826496,4096
squeeze-280,64,7.104278911063552,0.0,1182830592,1182830592,0
squeeze-303,64,7.070553200522183,0.0,1182830592,1182830592,0
squeeze-326,64,6.985236463271813,0.0,1182834688,1182830592,4096
squeeze-349,64,6.96975074028355,0.0,1182834688,1182834688,0
squeeze-372,64,6.904609999488405,0.0,1182838784,1182838784,0
split-120,64,7294.570081901631,0.0,1182838784,1182838784,0
squeeze-128,64,6.955878142483898,0.0,1182838784,1182838784,0
squeeze-138,64,7.074326968994747,0.0,1182838784,1182838784,0
split-150,64,35.16771189664414,0.0,1182846976,1182842880,4096
split-172,64,7296.633229743728,0.0,1182846976,1182846976,0
split-388,64,7292.426496835956,0.0,1182846976,1182846976,0
squeeze-396,64,7.07110312993213,0.0,1182846976,1182846976,0
squeeze-406,64,7.140590700193684,0.0,1182846976,1182846976,0
split-418,64,35.08598460966157,0.0,1182859264,1182855168,4096
split-440,64,7284.17506265209,0.0,1182859264,1182859264,0
split-656,64,7287.269634460571,0.0,1182859264,1182859264,0
squeeze-664,64,6.765040234677217,0.0,1182859264,1182859264,0
squeeze-674,64,6.88648459297235,0.0,1182863360,1182859264,4096
split-686,64,36.13695497638884,0.0,1182863360,1182863360,0
split-708,64,7293.447090114051,0.0,1182863360,1182863360,0
split-924,64,7281.67115714743,0.0,1182867456,1182863360,4096
squeeze-932,64,6.862214677739052,0.0,1182867456,1182867456,0
squeeze-942,64,6.80805053538155,0.0,1182867456,1182867456,0
split-954,64,34.177444330159226,0.0,1182871552,1182867456,4096
split-976,64,7288.656394857293,0.0,1182871552,1182871552,0
split-1192,64,7311.426118345098,0.0,1182875648,1182875648,0
squeeze-1200,64,6.8367642526948265,0.0,1182875648,1182875648,0
squeeze-1210,64,6.764187579385867,0.0,1182879744,1182875648,4096
split-1222,64,35.189668479029706,0.0,1182883840,1182883840,0
split-1244,64,7316.5983655687605,0.0,1182883840,1182883840,0
split-1460,64,7293.425346252904,0.0,1182883840,1182883840,0
squeeze-1468,64,6.889725951351222,0.0,1182883840,1182883840,0
squeeze-1478,64,6.967460809174318,0.0,1182887936,1182883840,4096
split-1490,64,35.37323248570722,0.0,1182896128,1182892032,4096
split-1512,64,7297.894846918026,0.0,1182896128,1182896128,0
squeeze-118,64,6.780655515658219,0.0,1182896128,1182896128,0
split-127,64,7999.720454835825,0.0,1182896128,1182896128,0
split-137,64,7758.063443640925,0.0,1182896128,1182896128,0
squeeze-148,64,6.860194320446882,0.0,1183035392,1183035392,0
squeeze-160,64,6.8752364895345055,0.0,1183035392,1183035392,0
squeeze-170,64,7.021260399665658,0.0,1183039488,1183039488,0
squeeze-386,64,7.012651029510432,0.0,1183039488,1183039488,0
split-395,64,7757.314648497987,0.0,1183039488,1183039488,0
split-405,64,7815.918736207378,0.0,1183043584,1183043584,0
squeeze-416,64,6.887769835664963,0.0,1183088640,1183051776,36864
squeeze-428,64,6.848849531912274,0.0,1183088640,1183088640,0
squeeze-438,64,6.789003824052122,0.0,1183088640,1183088640,0
squeeze-654,64,7.0174444260986615,0.0,1183092736,1183088640,4096
split-663,64,7691.950779820012,0.0,1183100928,1183092736,8192
split-673,64,7843.186483533637,0.0,1183105024,1183105024,0
squeeze-684,64,6.999526995711179,0.0,1183105024,1183105024,0
squeeze-696,64,6.892537453887011,0.0,1183105024,1183105024,0
squeeze-706,64,6.768074504163194,0.0,1183113216,1183109120,4096
squeeze-922,64,6.76763225075062,0.0,1183121408,1183117312,4096
split-931,64,7748.888904928256,0.0,1183121408,1183121408,0
split-941,64,7731.616242776352,0.0,1183150080,1183150080,0
squeeze-952,64,6.792540862319775,0.0,1183154176,1183154176,0
squeeze-964,64,7.126326949238251,0.0,1183154176,1183154176,0
squeeze-974,64,6.834284462470224,0.0,1183154176,1183154176,0
squeeze-1190,64,7.04305991965784,0.0,1183154176,1183154176,0
split-1199,64,7746.559133797371,0.0,1183154176,1183154176,0
split-1209,64,7697.018201926179,0.0,1183154176,1183154176,0
squeeze-1220,64,7.224769139260932,0.0,1183154176,1183154176,0
squeeze-1232,64,7.014357213698862,0.0,1183154176,1183154176,0
squeeze-1242,64,6.967920716080073,0.0,1183154176,1183154176,0
squeeze-1458,64,7.098477595528823,0.0,1183154176,1183154176,0
split-1467,64,7752.7991908733,0.0,1183215616,1183215616,0
split-1477,64,7711.877193521619,0.0,1183215616,1183215616,0
squeeze-1488,64,6.977512386988977,0.0,1183215616,1183215616,0
squeeze-1500,64,6.783892755027765,0.0,1183215616,1183215616,0
squeeze-1510,64,6.980601646954321,0.0,1183215616,1183215616,0
tuple-114,128,5.2155080217624805,0.0,1183215616,1183215616,0
tuple-125,256,7.0127228698570026,0.0,1183215616,1183215616,0
tuple-135,256,7.106454807283291,0.0,1183215616,1183215616,0
split-147,64,7285.845352391226,0.0,1183215616,1183215616,0
split-159,64,7295.201211456713,0.0,1183215616,1183215616,0
tuple-393,256,6.9991703437592925,0.0,1183215616,1183215616,0
tuple-403,256,6.881314209785108,0.0,1183215616,1183215616,0
split-415,64,7433.218833126442,0.0,1183215616,1183215616,0
split-427,64,7269.82418107568,0.0,1183215616,1183215616,0
tuple-661,256,7.114764105286797,0.0,1183215616,1183215616,0
tuple-671,256,7.079707028424884,0.0,1183215616,1183215616,0
split-683,64,7286.207744513853,0.0,1183215616,1183215616,0
split-695,64,7276.407870869129,0.0,1183215616,1183215616,0
tuple-929,256,7.157275922456089,0.0,1183215616,1183215616,0
tuple-939,256,7.152019192282741,0.0,1183215616,1183215616,0
split-951,64,7269.439163967522,0.0,1183334400,1183215616,118784
split-963,64,7290.0815935868295,0.0,1183338496,1183305728,32768
tuple-1197,256,7.119331772820163,0.0,1183301632,1183301632,0
tuple-1207,256,7.053777022701083,0.0,1183301632,1183301632,0
split-1219,64,7300.112151571111,0.0,1183346688,1183346688,0
split-1231,64,7279.502280915854,0.0,1183346688,1183338496,8192
tuple-1465,256,7.127846851393272,0.0,1183301632,1183301632,0
tuple-1475,256,7.236609112244926,0.0,1183301632,1183301632,0
split-1487,64,7278.543491971961,0.0,1183354880,1183354880,0
split-1499,64,7361.571101271922,0.0,1183354880,1183354880,0
concatenate-113,128,7278.6377438136815,0.0,1183367168,1183367168,0
concatenate-124,256,7682.660675054923,0.0,1183371264,1183371264,0
concatenate-134,256,7405.718349355302,0.0,1183371264,1183371264,0
tuple-145,256,6.921395734160901,0.0,1183371264,1183371264,0
tuple-157,256,7.067633744822959,0.0,1183371264,1183371264,0
concatenate-392,256,7417.454703129301,0.0,1183383552,1183383552,0
concatenate-402,256,7220.24140274194,0.0,1183383552,1183383552,0
tuple-413,256,7.078759388336331,0.0,1183395840,1183395840,0
tuple-425,256,6.922339225614566,0.0,1183395840,1183395840,0
concatenate-660,256,6474.4239614099815,0.0,1183408128,1183408128,0
concatenate-670,256,6477.299658953273,0.0,1183408128,1183408128,0
tuple-681,256,7.043067639681106,0.0,1183408128,1183408128,0
tuple-693,256,7.177057280709414,0.0,1183408128,1183408128,0
concatenate-928,256,6425.225517520665,0.0,1183412224,1183412224,0
concatenate-938,256,6436.208841621522,0.0,1183412224,1183412224,0
tuple-949,256,6.978679116428387,0.0,1183412224,1183412224,0
tuple-961,256,6.960169108322321,0.0,1183412224,1183412224,0
concatenate-1196,256,6438.883258441391,0.0,1183412224,1183412224,0
concatenate-1206,256,6423.129517474579,0.0,1183412224,1183412224,0
tuple-1217,256,6.9495873585258625,0.0,1183412224,1183412224,0
tuple-1229,256,7.006459211907508,0.0,1183412224,1183412224,0
concatenate-1464,256,6454.153841201164,0.0,1183412224,1183412224,0
concatenate-1474,256,6419.345675214989,0.0,1183412224,1183412224,0
tuple-1485,256,7.160855884835659,0.0,1183412224,1183412224,0
tuple-1497,256,7.1048544110155305,0.0,1183412224,1183412224,0
tuple-123,128,5.2660708229656485,0.0,1183412224,1183412224,0
tuple-191,128,5.476576578774685,0.0,1183412224,1183412224,0
tuple-214,128,5.27660861288858,0.0,1183412224,1183412224,0
tuple-237,128,5.469559340581297,0.0,1183412224,1183412224,0
tuple-260,128,5.34371958218624,0.0,1183412224,1183412224,0
tuple-283,128,5.214320435698392,0.0,1183412224,1183412224,0
tuple-306,128,5.400133906785941,0.0,1183412224,1183412224,0
tuple-329,128,5.366957606752383,0.0,1183412224,1183412224,0
tuple-352,128,5.329594485576132,0.0,1183412224,1183412224,0
tuple-375,128,5.260613459658156,0.0,1183412224,1183412224,0
concatenate-144,256,6582.773911337139,0.0,1183424512,1183424512,0
concatenate-156,256,6608.001068672075,0.0,1183428608,1183428608,0
tuple-391,128,5.28634203590363,0.0,1183428608,1183428608,0
tuple-459,128,5.197960050389831,0.0,1183428608,1183428608,0
tuple-482,128,5.242343158188275,0.0,1183428608,1183428608,0
tuple-505,128,5.207286441594244,0.0,1183428608,1183428608,0
tuple-528,128,5.323273522052974,0.0,1183428608,1183428608,0
tuple-551,128,5.155725408673641,0.0,1183428608,1183428608,0
tuple-574,128,5.431691195590373,0.0,1183428608,1183428608,0
tuple-597,128,5.149552928889149,0.0,1183428608,1183428608,0
tuple-620,128,5.283023963474734,0.0,1183428608,1183428608,0
tuple-643,128,5.3109616637195245,0.0,1183428608,1183428608,0
concatenate-412,256,6580.9920797810755,0.0,1183444992,1183440896,4096
concatenate-424,256,6592.586252267861,0.0,1183444992,1183444992,0
tuple-659,128,5.1788061261592775,0.0,1183444992,1183444992,0
tuple-727,128,5.171944100918457,0.0,1183444992,1183444992,0
tuple-750,128,5.3470466425964,0.0,1183444992,1183444992,0
tuple-773,128,5.110973350938716,0.0,1183444992,1183444992,0
tuple-796,128,5.23102168585965,0.0,1183444992,1183444992,0
tuple-819,128,5.233417341386416,0.0,1183444992,1183444992,0
tuple-842,128,5.135079856155984,0.0,1183444992,1183444992,0
tuple-865,128,5.132873493032338,0.0,1183444992,1183444992,0
tuple-888,128,5.144135725550153,0.0,1183444992,1183444992,0
tuple-911,128,5.2104525945051785,0.0,1183444992,1183444992,0
concatenate-680,256,6601.923132817346,0.0,1183461376,1183453184,8192
concatenate-692,256,6572.838261864858,0.0,1183465472,1183461376,4096
tuple-927,128,5.204832325692632,0.0,1183465472,1183465472,0
tuple-995,128,5.232598621887453,0.0,1183465472,1183465472,0
tuple-1018,128,5.105195646264322,0.0,1183465472,1183465472,0
tuple-1041,128,5.298223543205548,0.0,1183465472,1183465472,0
tuple-1064,128,5.18894997809326,0.0,1183465472,1183465472,0
tuple-1087,128,5.230770463788664,0.0,1183465472,1183465472,0
tuple-1110,128,5.234844360964668,0.0,1183465472,1183465472,0
tuple-1133,128,5.355880749901179,0.0,1183465472,1183465472,0
tuple-1156,128,5.237992238176738,0.0,1183465472,1183465472,0
tuple-1179,128,5.3598321215525315,0.0,1183465472,1183465472,0
concatenate-948,256,6597.5784356904005,0.0,1183481856,1183477760,4096
concatenate-960,256,6574.299762239415,0.0,1183485952,1183481856,4096
tuple-1195,128,5.347538762276909,0.0,1183485952,1183485952,0
tuple-1263,128,5.413268034939512,0.0,1183485952,1183485952,0
tuple-1286,128,5.481267156070399,0.0,1183485952,1183485952,0
tuple-1309,128,5.37604988163797,0.0,1183485952,1183485952,0
tuple-1332,128,5.355133940398512,0.0,1183485952,1183485952,0
tuple-1355,128,5.3060727603414986,0.0,1183485952,1183485952,0
tuple-1378,128,5.3205963063895245,0.0,1183485952,1183485952,0
tuple-1401,128,5.302376160856326,0.0,1183485952,1183485952,0
tuple-1424,128,5.411952693366617,0.0,1183485952,1183485952,0
tuple-1447,128,5.317753295579065,0.0,1183485952,1183485952,0
concatenate-1216,256,6580.437336350838,0.0,1183510528,1183498240,12288
concatenate-1228,256,6578.965894922133,0.0,1183518720,1183514624,4096
tuple-1463,128,5.125924444459977,0.0,1183518720,1183518720,0
tuple-1531,128,5.270079141736994,0.0,1183518720,1183518720,0
tuple-1554,128,5.212944883930492,0.0,1183518720,1183518720,0
tuple-1577,128,5.184992063428276,0.0,1183518720,1183518720,0
tuple-1600,128,5.292461059122128,0.0,1183518720,1183518720,0
tuple-1623,128,5.217122806040715,0.0,1183518720,1183518720,0
tuple-1646,128,5.370019500253003,0.0,1183518720,1183518720,0
tuple-1669,128,5.274648864102372,0.0,1183518720,1183518720,0
tuple-1692,128,5.316048688140871,0.0,1183518720,1183518720,0
tuple-1715,128,5.260235087485149,0.0,1183518720,1183518720,0
concatenate-1484,256,6601.437877385156,0.0,1183543296,1183539200,4096
concatenate-1496,256,6581.0834188304,0.0,1183543296,1183543296,0
concatenate-122,128,6707.285982130265,0.0,1183547392,1183543296,4096
concatenate-190,128,6716.638533342287,0.0,1183555584,1183547392,8192
concatenate-213,128,6721.971294684696,0.0,1183555584,1183555584,0
concatenate-236,128,6710.023564104283,0.0,1183555584,1183555584,0
concatenate-259,128,6701.061637794752,0.0,1183555584,1183555584,0
concatenate-282,128,6725.408734899775,0.0,1183555584,1183555584,0
concatenate-305,128,6725.883297687745,0.0,1183555584,1183555584,0
concatenate-328,128,6711.735217922388,0.0,1183555584,1183555584,0
concatenate-351,128,6721.509947037404,0.0,1183555584,1183555584,0
concatenate-374,128,6706.050435534278,0.0,1183555584,1183555584,0
concatenate-390,128,6536.393591183306,0.0,1183555584,1183555584,0
concatenate-458,128,6527.12138019236,0.0,1183555584,1183555584,0
concatenate-481,128,6545.263674045792,0.0,1183555584,1183555584,0
concatenate-504,128,6531.906740475416,0.0,1183555584,1183555584,0
concatenate-527,128,6542.830385469223,0.0,1183555584,1183555584,0
concatenate-550,128,6538.807502906332,0.0,1183563776,1183563776,0
concatenate-573,128,6617.719353608668,0.0,1183563776,1183563776,0
concatenate-596,128,6589.531914613775,0.0,1183563776,1183563776,0
concatenate-619,128,6515.790173922099,0.0,1183563776,1183563776,0
concatenate-642,128,6583.345497088324,0.0,1183567872,1183567872,0
concatenate-658,128,6573.690927400898,0.0,1183567872,1183567872,0
concatenate-726,128,6595.455004170142,0.0,1183567872,1183567872,0
concatenate-749,128,6588.984307491644,0.0,1183571968,1183567872,4096
concatenate-772,128,6583.9977637463835,0.0,1183571968,1183571968,0
concatenate-795,128,6606.292884597604,0.0,1183576064,1183571968,4096
concatenate-818,128,6590.215930299845,0.0,1183576064,1183576064,0
concatenate-841,128,6595.504547731406,0.0,1183576064,1183576064,0
concatenate-864,128,6576.780468520752,0.0,1183584256,1183584256,0
concatenate-887,128,6584.970474849678,0.0,1183588352,1183588352,0
concatenate-910,128,6558.331336749807,0.0,1183588352,1183588352,0
concatenate-926,128,6583.475806876218,0.0,1183588352,1183588352,0
concatenate-994,128,6578.882714266963,0.0,1183588352,1183588352,0
concatenate-1017,128,6605.560413542737,0.0,1183588352,1183588352,0
concatenate-1040,128,6565.89084710202,0.0,1183588352,1183588352,0
concatenate-1063,128,6588.145767285875,0.0,1183588352,1183588352,0
concatenate-1086,128,6593.405652846786,0.0,1183588352,1183588352,0
concatenate-1109,128,6593.953073045595,0.0,1183588352,1183588352,0
concatenate-1132,128,6567.853100497772,0.0,1183588352,1183588352,0
concatenate-1155,128,6579.223613726977,0.0,1183588352,1183588352,0
concatenate-1178,128,6519.862300423589,0.0,1183588352,1183588352,0
concatenate-1194,128,6581.395525233006,0.0,1183588352,1183588352,0
concatenate-1262,128,6599.533649351505,0.0,1183588352,1183588352,0
concatenate-1285,128,6589.235719474074,0.0,1183588352,1183588352,0
concatenate-1308,128,6567.7189098444505,0.0,1183588352,1183588352,0
concatenate-1331,128,6588.426321361675,0.0,1183588352,1183588352,0
concatenate-1354,128,6593.999341212431,0.0,1183588352,1183588352,0
concatenate-1377,128,6581.549649816696,0.0,1183621120,1183588352,32768
concatenate-1400,128,6581.849082623029,0.0,1183621120,1183588352,32768
concatenate-1423,128,6584.082590394307,0.0,1183625216,1183592448,32768
concatenate-1446,128,6587.9158426719405,0.0,1183629312,1183625216,4096
concatenate-1462,128,6575.34140884632,0.0,1183633408,1183629312,4096
concatenate-1530,128,6569.729331897684,0.0,1183637504,1183633408,4096
concatenate-1553,128,6621.943631000973,0.0,1183641600,1183641600,0
concatenate-1576,128,6605.275006921647,0.0,1183641600,1183641600,0
concatenate-1599,128,6584.490695383808,0.0,1183649792,1183645696,4096
concatenate-1622,128,6588.727600824932,0.0,1183649792,1183649792,0
concatenate-1645,128,6562.47033925844,0.0,1183653888,1183653888,0
concatenate-1668,128,6569.847844621094,0.0,1183653888,1183653888,0
concatenate-1691,128,6592.662912551684,0.0,1183657984,1183653888,4096
concatenate-1714,128,6595.651722367746,0.0,1183662080,1183657984,4096
nn.dense-112,128,9204.20846449171,0.0,1184149504,1184120832,28672
add-111,128,6221.053340945194,0.0,1184215040,1184215040,0
add-110,128,6233.234808860617,0.0,1184215040,1184215040,0
split-109,64,6335.0573519147365,0.0,1184219136,1184219136,0
sigmoid-107,64,6221.436712126229,0.0,1184219136,1184219136,0
sigmoid-168,64,6246.328861894648,0.0,1184223232,1184219136,4096
sigmoid-175,64,6215.7460149965245,0.0,1184227328,1184223232,4096
tanh-177,64,6233.115347818036,0.0,1184231424,1184231424,0
multiply-167,128,6227.267220408918,0.0,1184231424,1184231424,0
multiply-174,128,6217.023778169801,0.0,1184231424,1184231424,0
add-166,128,6218.9018088496005,0.0,1184239616,1184235520,4096
tanh-165,64,6297.254113888785,0.0,1184239616,1184239616,0
multiply-106,128,6223.904142821597,0.0,1184239616,1184239616,0
tuple-187,128,5.128974330348882,0.0,1184239616,1184239616,0
concatenate-186,128,6181.733009597193,0.0,1184256000,1184251904,4096
nn.dense-185,128,9301.701437664617,0.0,1184256000,1184256000,0
add-184,128,6417.744488143583,0.0,1184256000,1184256000,0
add-183,128,6410.063385817393,0.0,1184256000,1184256000,0
split-182,64,6344.771529087205,0.0,1184256000,1184256000,0
sigmoid-180,64,6244.734399421017,0.0,1184256000,1184256000,0
sigmoid-195,64,6255.559189537838,0.0,1184256000,1184256000,0
sigmoid-198,64,6238.0011723037005,0.0,1184256000,1184256000,0
tanh-200,64,6286.915782106614,0.0,1184256000,1184256000,0
multiply-194,128,6213.220970131494,0.0,1184256000,1184256000,0
multiply-197,128,6220.776705911361,0.0,1184256000,1184256000,0
add-193,128,6220.733149740765,0.0,1184256000,1184256000,0
tanh-192,64,6276.852766382256,0.0,1184256000,1184256000,0
multiply-179,128,6237.623733071346,0.0,1184256000,1184256000,0
tuple-210,128,5.270397373817254,0.0,1184256000,1184256000,0
concatenate-209,128,6188.186152590981,0.0,1184256000,1184256000,0
nn.dense-208,128,9539.01449487555,0.0,1184256000,1184256000,0
add-207,128,6416.28295786935,0.0,1184256000,1184256000,0
add-206,128,6419.93420822814,0.0,1184256000,1184256000,0
split-205,64,6326.914354738766,0.0,1184256000,1184256000,0
sigmoid-203,64,6240.001525553013,0.0,1184256000,1184256000,0
sigmoid-218,64,6253.430063726103,0.0,1184256000,1184256000,0
sigmoid-221,64,6242.991616406239,0.0,1184256000,1184256000,0
tanh-223,64,6291.089419184055,0.0,1184256000,1184256000,0
multiply-217,128,6225.799756194648,0.0,1184256000,1184256000,0
multiply-220,128,6226.6858894382585,0.0,1184256000,1184256000,0
add-216,128,6213.634488582037,0.0,1184256000,1184256000,0
tanh-215,64,6283.668563460958,0.0,1184256000,1184256000,0
multiply-202,128,6211.0745320025835,0.0,1184256000,1184256000,0
tuple-233,128,5.307248747915466,0.0,1184256000,1184256000,0
concatenate-232,128,6181.227634550593,0.0,1184256000,1184256000,0
nn.dense-231,128,9285.684627340685,0.0,1184256000,1184256000,0
add-230,128,6243.85584911309,0.0,1184260096,1184260096,0
add-229,128,6223.891391495771,0.0,1184260096,1184260096,0
split-228,64,6332.054664843979,0.0,1184264192,1184264192,0
sigmoid-226,64,6247.1669805790125,0.0,1184272384,1184268288,4096
sigmoid-241,64,6234.911438177523,0.0,1184272384,1184272384,0
sigmoid-244,64,6262.89221504407,0.0,1184276480,1184276480,0
tanh-246,64,6194.452819204282,0.0,1184284672,1184276480,8192
multiply-240,128,6247.972686058274,0.0,1184284672,1184284672,0
multiply-243,128,6246.472600249124,0.0,1184288768,1184284672,4096
add-239,128,6265.2379088600155,0.0,1184292864,1184288768,4096
tanh-238,64,6227.253725426179,0.0,1184292864,1184292864,0
multiply-225,128,6248.291450406478,0.0,1184292864,1184292864,0
tuple-256,128,5.294453532453053,0.0,1184292864,1184292864,0
concatenate-255,128,6187.470347572431,0.0,1184305152,1184305152,0
nn.dense-254,128,9252.70795289622,0.0,1184309248,1184309248,0
add-253,128,6236.076615813445,0.0,1184309248,1184309248,0
add-252,128,6238.982967580469,0.0,1184309248,1184309248,0
split-251,64,6361.146822823281,0.0,1184309248,1184309248,0
sigmoid-249,64,6248.175819580084,0.0,1184309248,1184309248,0
sigmoid-264,64,6262.193759905529,0.0,1184309248,1184309248,0
sigmoid-267,64,6257.321693718472,0.0,1184309248,1184309248,0
tanh-269,64,6238.92017344876,0.0,1184309248,1184309248,0
multiply-263,128,6285.056032867953,0.0,1184309248,1184309248,0
multiply-266,128,6248.962278531624,0.0,1184317440,1184317440,0
add-262,128,6262.599837824351,0.0,1184317440,1184317440,0
tanh-261,64,6234.166687220595,0.0,1184317440,1184317440,0
multiply-248,128,6241.237830354581,0.0,1184317440,1184317440,0
tuple-279,128,5.445620350327348,0.0,1184317440,1184317440,0
concatenate-278,128,6270.36543444788,0.0,1184317440,1184317440,0
nn.dense-277,128,9339.35056051331,0.0,1184317440,1184317440,0
add-276,128,6390.099233819049,0.0,1184317440,1184317440,0
add-275,128,6417.813245287857,0.0,1184317440,1184317440,0
split-274,64,6325.656712834252,0.0,1184321536,1184317440,4096
sigmoid-272,64,6247.256230782305,0.0,1184321536,1184321536,0
sigmoid-287,64,6251.131354623511,0.0,1184329728,1184329728,0
sigmoid-290,64,6249.384966780613,0.0,1184329728,1184329728,0
tanh-292,64,6219.856371222092,0.0,1184329728,1184329728,0
multiply-286,128,6247.167038890067,0.0,1184329728,1184329728,0
multiply-289,128,6242.322278025938,0.0,1184329728,1184329728,0
add-285,128,6244.556557018913,0.0,1184333824,1184329728,4096
tanh-284,64,6219.761407872646,0.0,1184333824,1184333824,0
multiply-271,128,6239.272702018643,0.0,1184333824,1184333824,0
tuple-302,128,5.4413334411690055,0.0,1184333824,1184333824,0
concatenate-301,128,6265.035137678288,0.0,1184337920,1184337920,0
nn.dense-300,128,9398.596117906112,0.0,1184337920,1184337920,0
add-299,128,6316.699406938658,0.0,1184346112,1184342016,4096
add-298,128,6234.554607890853,0.0,1184346112,1184346112,0
split-297,64,6339.092059226205,0.0,1184350208,1184350208,0
sigmoid-295,64,6280.3889611363975,0.0,1184350208,1184350208,0
sigmoid-310,64,6247.730286413771,0.0,1184350208,1184350208,0
sigmoid-313,64,6290.373492468599,0.0,1184350208,1184350208,0
tanh-315,64,6204.041070078223,0.0,1184350208,1184350208,0
multiply-309,128,6251.842527845763,0.0,1184350208,1184350208,0
multiply-312,128,6255.034798789338,0.0,1184350208,1184350208,0
add-308,128,6245.275699767785,0.0,1184350208,1184350208,0
tanh-307,64,6233.006123310811,0.0,1184350208,1184350208,0
multiply-294,128,6242.401329989644,0.0,1184350208,1184350208,0
tuple-325,128,5.337332175684131,0.0,1184350208,1184350208,0
concatenate-324,128,6194.472444526684,0.0,1184350208,1184350208,0
nn.dense-323,128,9581.437242884727,0.0,1184358400,1184350208,8192
add-322,128,6227.548310355013,0.0,1184350208,1184350208,0
add-321,128,6262.556839211739,0.0,1184350208,1184350208,0
split-320,64,6420.752235350979,0.0,1184350208,1184350208,0
sigmoid-318,64,6339.477463849064,0.0,1184350208,1184350208,0
sigmoid-333,64,6265.673967796503,0.0,1184382976,1184354304,28672
sigmoid-336,64,6282.985411161201,0.0,1184387072,1184387072,0
tanh-338,64,6255.51986122724,0.0,1184387072,1184387072,0
multiply-332,128,6275.7971953614615,0.0,1184387072,1184387072,0
multiply-335,128,6262.537091184752,0.0,1184391168,1184391168,0
add-331,128,6262.8507617771875,0.0,1184395264,1184395264,0
tanh-330,64,6227.480090036313,0.0,1184399360,1184395264,4096
multiply-317,128,6264.622126740392,0.0,1184411648,1184407552,4096
tuple-348,128,5.404457965036957,0.0,1184411648,1184411648,0
concatenate-347,128,6229.093601689652,0.0,1184415744,1184411648,4096
nn.dense-346,128,9342.047301663495,0.0,1184415744,1184415744,0
add-345,128,6443.392477143129,0.0,1184428032,1184423936,4096
add-344,128,6447.203506225225,0.0,1184428032,1184428032,0
split-343,64,6557.200533610141,0.0,1184444416,1184440320,4096
sigmoid-341,64,6450.486809037131,0.0,1184444416,1184444416,0
sigmoid-356,64,6495.8807658694195,0.0,1184444416,1184444416,0
sigmoid-359,64,6469.858388880442,0.0,1184452608,1184448512,4096
tanh-361,64,6381.454615900812,0.0,1184452608,1184452608,0
multiply-355,128,6285.258477113156,0.0,1184452608,1184452608,0
multiply-358,128,6270.160331255896,0.0,1184452608,1184452608,0
add-354,128,6259.534386782592,0.0,1184460800,1184452608,8192
tanh-353,64,6258.17908119978,0.0,1184464896,1184460800,4096
multiply-340,128,6266.388705940694,0.0,1184464896,1184464896,0
tuple-371,128,5.156776052013513,0.0,1184464896,1184464896,0
concatenate-370,128,6278.707305176532,0.0,1184464896,1184464896,0
nn.dense-369,128,9681.10588704622,0.0,1184464896,1184464896,0
add-368,128,6251.200600567114,0.0,1184464896,1184464896,0
add-367,128,6268.204998247986,0.0,1184464896,1184464896,0
split-366,64,6379.660934263169,0.0,1184464896,1184464896,0
sigmoid-364,64,6272.637773848489,0.0,1184473088,1184473088,0
sigmoid-379,64,6263.862188838538,0.0,1184473088,1184473088,0
sigmoid-382,64,6280.801255780727,0.0,1184473088,1184473088,0
tanh-384,64,6236.597151678121,0.0,1184473088,1184473088,0
multiply-378,128,6260.825360110161,0.0,1184473088,1184473088,0
multiply-381,128,6269.586572520327,0.0,1184473088,1184473088,0
add-377,128,6292.638150990041,0.0,1184473088,1184473088,0
tanh-376,64,6251.095340278211,0.0,1184473088,1184473088,0
expand_dims-1736,64,6.770626781959579,0.0,1184473088,1184473088,0
multiply-363,128,6260.2703386486555,0.0,1184473088,1184473088,0
tuple-105,640,12.213409217819393,0.0,1184477184,1184477184,0
expand_dims-1728,64,7.093353744714087,0.0,1184477184,1184477184,0
stack-104,640,6747.468462065851,0.0,1186402304,1186390016,12288
expand_dims-103,64,7.12327596407476,0.0,1184931840,1186467840,0
squeeze-102,64,6.970373457098544,0.0,1187868672,1187868672,0
split-101,64,6386.2146453668065,0.0,1187876864,1187872768,4096
squeeze-99,64,6.9532110869887065,0.0,1187876864,1187876864,0
squeeze-456,64,7.090560008463388,0.0,1187876864,1187876864,0
squeeze-479,64,6.932248417364048,0.0,1187876864,1187876864,0
squeeze-502,64,6.97796511405169,0.0,1187880960,1187876864,4096
squeeze-525,64,6.973214004270079,0.0,1187880960,1187880960,0
squeeze-548,64,6.951609930544359,0.0,1187880960,1187880960,0
squeeze-571,64,6.885215505528975,0.0,1187880960,1187880960,0
squeeze-594,64,6.928117915129971,0.0,1187880960,1187880960,0
squeeze-617,64,7.052792181277743,0.0,1187885056,1187885056,0
squeeze-640,64,6.907141232591221,0.0,1187885056,1187885056,0
tuple-98,128,5.349639834773033,0.0,1187885056,1187885056,0
concatenate-97,128,6302.826615979092,0.0,1187897344,1187897344,0
nn.dense-96,128,8768.542284084033,0.0,1187897344,1187897344,0
add-95,128,6264.660499086092,0.0,1187909632,1187909632,0
add-94,128,6255.098271679048,0.0,1187913728,1187909632,4096
split-93,64,6360.148372329602,0.0,1187917824,1187913728,4096
sigmoid-91,64,6257.511612978074,0.0,1187917824,1187917824,0
sigmoid-436,64,6271.101558072555,0.0,1187917824,1187917824,0
sigmoid-443,64,6261.280988025111,0.0,1187917824,1187917824,0
tanh-445,64,6246.706219557887,0.0,1187921920,1187921920,0
multiply-435,128,6286.198971934564,0.0,1187926016,1187921920,4096
multiply-442,128,6266.227074017012,0.0,1187926016,1187926016,0
add-434,128,6248.774014193614,0.0,1187926016,1187926016,0
tanh-433,64,6236.901095340945,0.0,1187926016,1187926016,0
multiply-90,128,6267.554593379332,0.0,1187926016,1187926016,0
tuple-455,128,5.198681678524834,0.0,1187926016,1187926016,0
concatenate-454,128,6244.5413605727745,0.0,1187926016,1187926016,0
nn.dense-453,128,8669.314816095133,0.0,1187926016,1187926016,0
add-452,128,6256.762897681106,0.0,1187930112,1187926016,4096
add-451,128,6278.333512325483,0.0,1187930112,1187930112,0
split-450,64,6397.746915384323,0.0,1187930112,1187930112,0
sigmoid-448,64,6251.249190533937,0.0,1187930112,1187930112,0
sigmoid-463,64,6267.090990816445,0.0,1187930112,1187930112,0
sigmoid-466,64,6269.1585181392975,0.0,1187930112,1187930112,0
tanh-468,64,6233.977440122421,0.0,1187930112,1187930112,0
multiply-462,128,6271.873708726194,0.0,1187930112,1187930112,0
multiply-465,128,6270.804940961397,0.0,1187930112,1187930112,0
add-461,128,6261.490956428133,0.0,1187930112,1187930112,0
tanh-460,64,6243.530522481925,0.0,1187930112,1187930112,0
multiply-447,128,6310.079758209851,0.0,1187934208,1187930112,4096
tuple-478,128,5.376689985629274,0.0,1187934208,1187934208,0
concatenate-477,128,6250.327677714851,0.0,1187942400,1187938304,4096
nn.dense-476,128,8813.34092903981,0.0,1187942400,1187942400,0
add-475,128,6439.07332492146,0.0,1187946496,1187946496,0
add-474,128,6454.550085566864,0.0,1187950592,1187950592,0
split-473,64,6501.624050682211,0.0,1187950592,1187950592,0
sigmoid-471,64,6276.098323658112,0.0,1187950592,1187950592,0
sigmoid-486,64,6273.277409449369,0.0,1187954688,1187954688,0
sigmoid-489,64,6268.651204420748,0.0,1187954688,1187954688,0
tanh-491,64,6243.9235198803435,0.0,1187954688,1187954688,0
multiply-485,128,6264.791571753985,0.0,1187954688,1187954688,0
multiply-488,128,6269.432566881775,0.0,1187958784,1187954688,4096
add-484,128,6314.688484239608,0.0,1187962880,1187962880,0
tanh-483,64,6242.806930507947,0.0,1187966976,1187962880,4096
multiply-470,128,6262.184642415667,0.0,1187966976,1187966976,0
tuple-501,128,5.268792185435002,0.0,1187966976,1187966976,0
concatenate-500,128,6242.377404570713,0.0,1187975168,1187975168,0
nn.dense-499,128,8920.935680267956,0.0,1187975168,1187975168,0
add-498,128,6431.726849489795,0.0,1187987456,1187987456,0
add-497,128,6262.45304074296,0.0,1187987456,1187987456,0
split-496,64,6376.381308765364,0.0,1187987456,1187987456,0
sigmoid-494,64,6286.090384711842,0.0,1187987456,1187987456,0
sigmoid-509,64,6280.628966861598,0.0,1187995648,1187991552,4096
sigmoid-512,64,6276.840770026201,0.0,1187995648,1187995648,0
tanh-514,64,6240.605204782773,0.0,1187999744,1187995648,4096
multiply-508,128,6280.000613374059,0.0,1187999744,1187999744,0
multiply-511,128,6268.220205968113,0.0,1188003840,1187999744,4096
add-507,128,6266.749414343877,0.0,1188007936,1188003840,4096
tanh-506,64,6255.464453508983,0.0,1188012032,1188007936,4096
multiply-493,128,6326.603659770347,0.0,1188012032,1188012032,0
tuple-524,128,5.186939505696598,0.0,1188012032,1188012032,0
concatenate-523,128,6306.791525487303,0.0,1188016128,1188016128,0
nn.dense-522,128,8976.768384761248,0.0,1188024320,1188020224,4096
add-521,128,6443.8833151301,0.0,1188028416,1188028416,0
add-520,128,6252.062628124652,0.0,1188028416,1188028416,0
split-519,64,6384.908223407241,0.0,1188028416,1188028416,0
sigmoid-517,64,6271.615192666993,0.0,1188028416,1188028416,0
sigmoid-532,64,6306.401542167168,0.0,1188028416,1188028416,0
sigmoid-535,64,6273.171728455399,0.0,1188028416,1188028416,0
tanh-537,64,6280.108681527776,0.0,1188028416,1188028416,0
multiply-531,128,6276.85478300045,0.0,1188028416,1188028416,0
multiply-534,128,6297.836369327073,0.0,1188028416,1188028416,0
add-530,128,6257.903369127181,0.0,1188036608,1188028416,8192
tanh-529,64,6253.298645108984,0.0,1188065280,1188028416,36864
multiply-516,128,6264.3048814051235,0.0,1188065280,1188065280,0
tuple-547,128,5.222488717244322,0.0,1188065280,1188065280,0
concatenate-546,128,6255.837136644255,0.0,1188069376,1188069376,0
nn.dense-545,128,8919.589557194282,0.0,1188069376,1188069376,0
add-544,128,6267.709177622134,0.0,1188077568,1188077568,0
add-543,128,6253.393256516665,0.0,1188077568,1188077568,0
split-542,64,6371.266720761317,0.0,1188081664,1188077568,4096
sigmoid-540,64,6265.89557560537,0.0,1188081664,1188081664,0
sigmoid-555,64,6266.833426682226,0.0,1188085760,1188081664,4096
sigmoid-558,64,6271.5491212906945,0.0,1188089856,1188085760,4096
tanh-560,64,6217.51085334523,0.0,1188093952,1188089856,4096
multiply-554,128,6262.883750807827,0.0,1188093952,1188093952,0
multiply-557,128,6266.023033736028,0.0,1188093952,1188093952,0
add-553,128,6266.81385368051,0.0,1188093952,1188093952,0
tanh-552,64,6244.989154197342,0.0,1188093952,1188093952,0
multiply-539,128,6259.414936876744,0.0,1188093952,1188093952,0
tuple-570,128,5.321272938162608,0.0,1188093952,1188093952,0
concatenate-569,128,6247.067490102534,0.0,1188093952,1188093952,0
nn.dense-568,128,8827.689903348291,0.0,1188093952,1188093952,0
add-567,128,6436.514288220891,0.0,1188093952,1188093952,0
add-566,128,6435.718139463049,0.0,1188093952,1188093952,0
split-565,64,6364.524163096132,0.0,1188093952,1188093952,0
sigmoid-563,64,6260.906780508538,0.0,1188093952,1188093952,0
sigmoid-578,64,6253.819184040798,0.0,1188093952,1188093952,0
sigmoid-581,64,6262.328368297202,0.0,1188093952,1188093952,0
tanh-583,64,6234.804941498631,0.0,1188093952,1188093952,0
multiply-577,128,6253.037683106694,0.0,1188093952,1188093952,0
multiply-580,128,6256.646972930473,0.0,1188093952,1188093952,0
add-576,128,6267.783839837794,0.0,1188093952,1188093952,0
tanh-575,64,6280.067341791119,0.0,1188093952,1188093952,0
multiply-562,128,6272.935264780331,0.0,1188093952,1188093952,0
tuple-593,128,5.438572780180802,0.0,1188093952,1188093952,0
concatenate-592,128,6242.165289835325,0.0,1188093952,1188093952,0
nn.dense-591,128,8720.177348990395,0.0,1188093952,1188093952,0
add-590,128,6245.809009795969,0.0,1188098048,1188093952,4096
add-589,128,6232.268237138804,0.0,1188098048,1188098048,0
split-588,64,6366.233050847458,0.0,1188098048,1188098048,0
sigmoid-586,64,6257.642539365158,0.0,1188098048,1188098048,0
sigmoid-601,64,6252.472549705266,0.0,1188098048,1188098048,0
sigmoid-604,64,6277.670426270426,0.0,1188098048,1188098048,0
tanh-606,64,6228.706502446327,0.0,1188098048,1188098048,0
multiply-600,128,6266.699897321012,0.0,1188098048,1188098048,0
multiply-603,128,6254.175730544833,0.0,1188102144,1188102144,0
add-599,128,6258.530103745604,0.0,1188102144,1188102144,0
tanh-598,64,6244.9677117979,0.0,1188102144,1188102144,0
multiply-585,128,6254.412970094019,0.0,1188102144,1188102144,0
tuple-616,128,5.365095412330175,0.0,1188102144,1188102144,0
concatenate-615,128,6243.471918183854,0.0,1188118528,1188106240,12288
nn.dense-614,128,8894.074774261493,0.0,1188118528,1188118528,0
add-613,128,6255.382037768296,0.0,1188118528,1188118528,0
add-612,128,6228.235448186608,0.0,1188118528,1188118528,0
split-611,64,6550.930966946039,0.0,1188118528,1188118528,0
sigmoid-609,64,6260.856862426386,0.0,1188122624,1188118528,4096
sigmoid-624,64,6257.6086986858945,0.0,1188126720,1188122624,4096
sigmoid-627,64,6253.396448668251,0.0,1188126720,1188126720,0
tanh-629,64,6229.522458570061,0.0,1188126720,1188126720,0
multiply-623,128,6263.0870886265875,0.0,1188126720,1188126720,0
multiply-626,128,6261.627731744561,0.0,1188130816,1188126720,4096
add-622,128,6254.284397853951,0.0,1188130816,1188130816,0
tanh-621,64,6233.245606571579,0.0,1188130816,1188130816,0
multiply-608,128,6250.785766926961,0.0,1188130816,1188130816,0
tuple-639,128,5.178740727496544,0.0,1188130816,1188130816,0
concatenate-638,128,6250.664044256297,0.0,1188130816,1188130816,0
nn.dense-637,128,8680.061496438328,0.0,1188130816,1188130816,0
add-636,128,6248.5519618526505,0.0,1188139008,1188139008,0
add-635,128,6247.235024076245,0.0,1188139008,1188139008,0
split-634,64,6344.264554001664,0.0,1188139008,1188139008,0
sigmoid-632,64,6266.432936130017,0.0,1188139008,1188139008,0
sigmoid-647,64,6264.821339857452,0.0,1188139008,1188139008,0
sigmoid-650,64,6255.909379795695,0.0,1188139008,1188139008,0
tanh-652,64,6245.6633317532,0.0,1188139008,1188139008,0
multiply-646,128,6270.369927087632,0.0,1188143104,1188143104,0
multiply-649,128,6252.357806308051,0.0,1188143104,1188143104,0
add-645,128,6259.5549523110785,0.0,1188147200,1188143104,4096
tanh-644,64,6232.6844459898,0.0,1188147200,1188147200,0
expand_dims-1737,64,6.83657360735364,0.0,1188147200,1188147200,0
multiply-631,128,6291.848092404621,0.0,1188147200,1188147200,0
tuple-89,640,13.298138334565085,0.0,1188147200,1188147200,0
expand_dims-1729,64,7.118718169287702,0.0,1188155392,1188151296,4096
stack-88,640,6714.599700524082,0.0,1188155392,1188155392,0
expand_dims-87,64,6.910433127792865,0.0,1189470208,1189470208,0
squeeze-86,64,6.845695561351554,0.0,1185808384,1185804288,4096
split-85,64,6404.127482971646,0.0,1187405824,1187299328,106496
squeeze-83,64,6.811485636932141,0.0,1187418112,1187418112,0
squeeze-724,64,6.863758472728031,0.0,1187418112,1187418112,0
squeeze-747,64,6.867960070237935,0.0,1187422208,1187422208,0
squeeze-770,64,6.978026217107017,0.0,1187426304,1187422208,4096
squeeze-793,64,7.069196930254799,0.0,1187426304,1187426304,0
squeeze-816,64,7.072914748129094,0.0,1187426304,1187426304,0
squeeze-839,64,6.890904164969878,0.0,1187430400,1187426304,4096
squeeze-862,64,7.016621113782041,0.0,1187430400,1187430400,0
squeeze-885,64,7.209070901522773,0.0,1187430400,1187430400,0
squeeze-908,64,7.03134021249065,0.0,1187430400,1187430400,0
tuple-82,128,5.411029059102813,0.0,1187430400,1187430400,0
concatenate-81,128,6261.700053420871,0.0,1187438592,1187438592,0
nn.dense-80,128,8933.765611336577,0.0,1187438592,1187438592,0
add-79,128,6390.6558765573345,0.0,1187442688,1187442688,0
add-78,128,6246.129364483232,0.0,1187442688,1187442688,0
split-77,64,6368.1737345885695,0.0,1187442688,1187442688,0
sigmoid-75,64,6255.626960655281,0.0,1187442688,1187442688,0
sigmoid-704,64,6266.415686127558,0.0,1187446784,1187442688,4096
sigmoid-711,64,6276.138001285894,0.0,1187450880,1187450880,0
tanh-713,64,6234.410605966343,0.0,1187450880,1187450880,0
multiply-703,128,6265.674659421015,0.0,1187450880,1187450880,0
multiply-710,128,6253.092180411662,0.0,1187450880,1187450880,0
add-702,128,6261.5889941317055,0.0,1187454976,1187454976,0
tanh-701,64,6217.580884727155,0.0,1187454976,1187454976,0
multiply-74,128,6253.3124042640875,0.0,1187454976,1187454976,0
tuple-723,128,5.21844664035101,0.0,1187454976,1187454976,0
concatenate-722,128,6236.6849332090715,0.0,1187459072,1187459072,0
nn.dense-721,128,8646.959926293312,0.0,1187467264,1187459072,8192
add-720,128,6243.609899841448,0.0,1187475456,1187475456,0
add-719,128,6231.7976308978705,0.0,1187475456,1187475456,0
split-718,64,6365.1377411167505,0.0,1187483648,1187475456,8192
sigmoid-716,64,6255.629857025319,0.0,1187483648,1187483648,0
sigmoid-731,64,6273.526433562937,0.0,1187483648,1187483648,0
sigmoid-734,64,6242.767968272577,0.0,1187487744,1187487744,0
tanh-736,64,6229.384744618501,0.0,1187487744,1187487744,0
multiply-730,128,6252.996593248892,0.0,1187491840,1187487744,4096
multiply-733,128,6263.147770110337,0.0,1187495936,1187495936,0
add-729,128,6330.283783783784,0.0,1187500032,1187495936,4096
tanh-728,64,6228.809929897544,0.0,1187500032,1187500032,0
multiply-715,128,6267.337106053027,0.0,1187504128,1187500032,4096
tuple-746,128,5.161836517758206,0.0,1187504128,1187504128,0
concatenate-745,128,6252.320810331476,0.0,1187508224,1187508224,0
nn.dense-744,128,8684.725167738812,0.0,1187508224,1187508224,0
add-743,128,6254.8368690016205,0.0,1187516416,1187512320,4096
add-742,128,6244.934733907502,0.0,1187516416,1187516416,0
split-741,64,6348.029266746943,0.0,1187520512,1187516416,4096
sigmoid-739,64,6242.539030408985,0.0,1187524608,1187524608,0
sigmoid-754,64,6255.376350405121,0.0,1187524608,1187524608,0
sigmoid-757,64,6269.016449262662,0.0,1187524608,1187524608,0
tanh-759,64,6235.3808698471275,0.0,1187524608,1187524608,0
multiply-753,128,6262.337266454764,0.0,1187524608,1187524608,0
multiply-756,128,6288.338137686941,0.0,1187524608,1187524608,0
add-752,128,6254.8888167180885,0.0,1187524608,1187524608,0
tanh-751,64,6242.976019780575,0.0,1187524608,1187524608,0
multiply-738,128,6255.3483335624405,0.0,1187524608,1187524608,0
tuple-769,128,5.32775623721829,0.0,1187524608,1187524608,0
concatenate-768,128,6247.462534718731,0.0,1187524608,1187524608,0
nn.dense-767,128,8992.797471642565,0.0,1187528704,1187524608,4096
add-766,128,6258.207352720731,0.0,1187528704,1187528704,0
add-765,128,6247.3662431212515,0.0,1187528704,1187528704,0
split-764,64,6357.037129492551,0.0,1187532800,1187528704,4096
sigmoid-762,64,6289.08240054572,0.0,1187532800,1187532800,0
sigmoid-777,64,6251.13930063438,0.0,1187532800,1187532800,0
sigmoid-780,64,6257.211931633342,0.0,1187532800,1187532800,0
tanh-782,64,6232.863559923764,0.0,1187532800,1187532800,0
multiply-776,128,6260.934150349596,0.0,1187532800,1187532800,0
multiply-779,128,6252.112595276772,0.0,1187532800,1187532800,0
add-775,128,6251.265066260319,0.0,1187532800,1187532800,0
tanh-774,64,6237.940918446796,0.0,1187532800,1187532800,0
multiply-761,128,6261.369539949758,0.0,1187536896,1187532800,4096
tuple-792,128,5.379104300704534,0.0,1187536896,1187536896,0
concatenate-791,128,6284.0726038358625,0.0,1187540992,1187536896,4096
nn.dense-790,128,8793.401692978812,0.0,1187540992,1187540992,0
add-789,128,6238.543542495231,0.0,1187545088,1187545088,0
add-788,128,6240.789753486056,0.0,1187545088,1187545088,0
split-787,64,6364.8565286887515,0.0,1187545088,1187545088,0
sigmoid-785,64,6246.233472622368,0.0,1187545088,1187545088,0
sigmoid-800,64,6253.80866218479,0.0,1187545088,1187545088,0
sigmoid-803,64,6235.243868704508,0.0,1187545088,1187545088,0
tanh-805,64,6240.691277135956,0.0,1187545088,1187545088,0
multiply-799,128,6264.167137535314,0.0,1187545088,1187545088,0
multiply-802,128,6263.855867888259,0.0,1187545088,1187545088,0
add-798,128,6256.274739420601,0.0,1187545088,1187545088,0
tanh-797,64,6232.857881495887,0.0,1187545088,1187545088,0
multiply-784,128,6268.714040903122,0.0,1187545088,1187545088,0
tuple-815,128,5.307426210918011,0.0,1187545088,1187545088,0
concatenate-814,128,6247.020097861124,0.0,1187545088,1187545088,0
nn.dense-813,128,8868.033478868623,0.0,1187545088,1187545088,0
add-812,128,6255.753615030521,0.0,1187545088,1187545088,0
add-811,128,6246.842295459998,0.0,1187545088,1187545088,0
split-810,64,6423.671496479322,0.0,1187545088,1187545088,0
sigmoid-808,64,6267.099733226457,0.0,1187545088,1187545088,0
sigmoid-823,64,6263.737455410225,0.0,1187545088,1187545088,0
sigmoid-826,64,6276.696787852972,0.0,1187545088,1187545088,0
tanh-828,64,6211.526759339705,0.0,1187545088,1187545088,0
multiply-822,128,6257.012400830893,0.0,1187545088,1187545088,0
multiply-825,128,6249.823675964254,0.0,1187545088,1187545088,0
add-821,128,6252.582342350695,0.0,1187545088,1187545088,0
tanh-820,64,6226.530881369738,0.0,1187545088,1187545088,0
multiply-807,128,6254.516695826043,0.0,1187545088,1187545088,0
tuple-838,128,5.37064610750919,0.0,1187545088,1187545088,0
concatenate-837,128,6247.369091022211,0.0,1187545088,1187545088,0
nn.dense-836,128,8694.268779972645,0.0,1187553280,1187545088,8192
add-835,128,6239.736384134141,0.0,1187573760,1187573760,0
add-834,128,6248.405974210784,0.0,1187573760,1187573760,0
split-833,64,6370.785115544345,0.0,1187577856,1187573760,4096
sigmoid-831,64,6272.142830503864,0.0,1187549184,1187545088,4096
sigmoid-846,64,6263.951799626051,0.0,1187573760,1187545088,28672
sigmoid-849,64,6262.896174397894,0.0,1187577856,1187573760,4096
tanh-851,64,6236.276209910291,0.0,1187577856,1187577856,0
multiply-845,128,6286.12080268228,0.0,1187581952,1187577856,4096
multiply-848,128,6261.005030281795,0.0,1187581952,1187581952,0
add-844,128,6252.0424825498785,0.0,1187581952,1187581952,0
tanh-843,64,6219.16457218633,0.0,1187581952,1187581952,0
multiply-830,128,6257.306391706164,0.0,1187590144,1187581952,8192
tuple-861,128,5.20912757164956,0.0,1187590144,1187590144,0
concatenate-860,128,6243.352792352656,0.0,1187594240,1187594240,0
nn.dense-859,128,9073.007022900763,0.0,1187594240,1187594240,0
add-858,128,6446.330192691887,0.0,1187594240,1187594240,0
add-857,128,6257.98966230186,0.0,1187594240,1187594240,0
split-856,64,6347.6830385756675,0.0,1187598336,1187594240,4096
sigmoid-854,64,6250.568676351394,0.0,1187598336,1187598336,0
sigmoid-869,64,6253.512590962515,0.0,1187598336,1187598336,0
sigmoid-872,64,6244.904643004283,0.0,1187598336,1187598336,0
tanh-874,64,6231.833364480159,0.0,1187602432,1187602432,0
multiply-868,128,6248.88816562133,0.0,1187610624,1187606528,4096
multiply-871,128,6250.106545336467,0.0,1187614720,1187614720,0
add-867,128,6255.020118169076,0.0,1187614720,1187614720,0
tanh-866,64,6247.965854978355,0.0,1187614720,1187614720,0
multiply-853,128,6293.736275551667,0.0,1187614720,1187614720,0
tuple-884,128,5.082933240110826,0.0,1187614720,1187614720,0
concatenate-883,128,6239.085628017817,0.0,1187622912,1187622912,0
nn.dense-882,128,8952.803769266779,0.0,1187627008,1187622912,4096
add-881,128,6452.041184190212,0.0,1187631104,1187627008,4096
add-880,128,6242.525105834421,0.0,1187631104,1187631104,0
split-879,64,6360.514484539329,0.0,1187635200,1187631104,4096
sigmoid-877,64,6260.891472748238,0.0,1187635200,1187635200,0
sigmoid-892,64,6244.074935801455,0.0,1187635200,1187635200,0
sigmoid-895,64,6275.821719592946,0.0,1187635200,1187635200,0
tanh-897,64,6216.28815370849,0.0,1187635200,1187635200,0
multiply-891,128,6238.260717399427,0.0,1187639296,1187639296,0
multiply-894,128,6238.709713092568,0.0,1187643392,1187639296,4096
add-890,128,6252.6549893179745,0.0,1187643392,1187643392,0
tanh-889,64,6240.125594279939,0.0,1187647488,1187643392,4096
multiply-876,128,6266.074951577632,0.0,1187647488,1187647488,0
tuple-907,128,5.290284877737184,0.0,1187651584,1187651584,0
concatenate-906,128,6230.066793612459,0.0,1187663872,1187659776,4096
nn.dense-905,128,8710.291484435298,0.0,1187663872,1187663872,0
add-904,128,6432.48527131783,0.0,1187663872,1187663872,0
add-903,128,6469.407569290894,0.0,1187667968,1187663872,4096
split-902,64,6336.659927587105,0.0,1187672064,1187667968,4096
sigmoid-900,64,6256.755781394535,0.0,1187672064,1187672064,0
sigmoid-915,64,6251.386810095671,0.0,1187676160,1187672064,4096
sigmoid-918,64,6246.157654067855,0.0,1187676160,1187676160,0
tanh-920,64,6229.1712720416635,0.0,1187676160,1187676160,0
multiply-914,128,6260.411462564205,0.0,1187680256,1187676160,4096
multiply-917,128,6250.85774753412,0.0,1187684352,1187680256,4096
add-913,128,6260.931044843386,0.0,1187684352,1187684352,0
tanh-912,64,6253.141825288918,0.0,1187688448,1187684352,4096
expand_dims-1738,64,7.051157289831625,0.0,1187692544,1187688448,4096
multiply-899,128,6250.905076460168,0.0,1187696640,1187692544,4096
tuple-73,640,13.684053493169214,0.0,1187696640,1187696640,0
expand_dims-1730,64,6.769428968424063,0.0,1187708928,1187704832,4096
stack-72,640,6735.315010975123,0.0,1187708928,1187708928,0
expand_dims-71,64,6.9037258567624376,0.0,1186205696,1189924864,0
squeeze-70,64,6.747427784194651,0.0,1185603584,1185599488,4096
split-69,64,6387.551191144212,0.0,1187786752,1187782656,4096
squeeze-67,64,6.713933883569905,0.0,1187880960,1187880960,0
squeeze-992,64,7.02956856020833,0.0,1187880960,1187880960,0
squeeze-1015,64,6.928156381963469,0.0,1187880960,1187880960,0
squeeze-1038,64,7.036373811428591,0.0,1187880960,1187880960,0
squeeze-1061,64,6.809740991211663,0.0,1187880960,1187880960,0
squeeze-1084,64,7.002816497467705,0.0,1187880960,1187880960,0
squeeze-1107,64,6.936481563753629,0.0,1187880960,1187880960,0
squeeze-1130,64,7.042647765702858,0.0,1187880960,1187880960,0
squeeze-1153,64,6.746264832877893,0.0,1187880960,1187880960,0
squeeze-1176,64,7.081345304665708,0.0,1187880960,1187880960,0
tuple-66,128,5.173599570438798,0.0,1187880960,1187880960,0
concatenate-65,128,6239.919720506582,0.0,1187880960,1187880960,0
nn.dense-64,128,8751.988943636581,0.0,1187880960,1187880960,0
add-63,128,6252.367406045815,0.0,1187880960,1187880960,0
add-62,128,6257.764910490679,0.0,1187880960,1187880960,0
split-61,64,6349.232029403219,0.0,1187880960,1187880960,0
sigmoid-59,64,6255.902666997073,0.0,1187880960,1187880960,0
sigmoid-972,64,6256.524109729085,0.0,1187880960,1187880960,0
sigmoid-979,64,6256.062729196871,0.0,1187880960,1187880960,0
tanh-981,64,6211.268237308323,0.0,1187880960,1187880960,0
multiply-971,128,6243.927186454301,0.0,1187880960,1187880960,0
multiply-978,128,6316.984643532926,0.0,1187880960,1187880960,0
add-970,128,6235.437371679092,0.0,1187880960,1187880960,0
tanh-969,64,6207.7743224957485,0.0,1187880960,1187880960,0
multiply-58,128,6249.664901705016,0.0,1187880960,1187880960,0
tuple-991,128,5.152953644773602,0.0,1187880960,1187880960,0
concatenate-990,128,6234.958124585716,0.0,1187880960,1187880960,0
nn.dense-989,128,8787.201638267723,0.0,1187880960,1187880960,0
add-988,128,6235.618860389635,0.0,1187885056,1187885056,0
add-987,128,6224.6189095439895,0.0,1187885056,1187885056,0
split-986,64,6350.918743909722,0.0,1187885056,1187885056,0
sigmoid-984,64,6261.730397489279,0.0,1187889152,1187885056,4096
sigmoid-999,64,6244.814042950514,0.0,1187889152,1187889152,0
sigmoid-1002,64,6248.874028323664,0.0,1187897344,1187889152,8192
tanh-1004,64,6233.50320274095,0.0,1187897344,1187897344,0
multiply-998,128,6246.0193463139785,0.0,1187897344,1187897344,0
multiply-1001,128,6232.573701584167,0.0,1187897344,1187897344,0
add-997,128,6243.680132261031,0.0,1187901440,1187901440,0
tanh-996,64,6228.636317294542,0.0,1187901440,1187901440,0
multiply-983,128,6238.579107309511,0.0,1187905536,1187901440,4096
tuple-1014,128,5.316339726829403,0.0,1187905536,1187905536,0
concatenate-1013,128,6215.0425687311645,0.0,1187909632,1187909632,0
nn.dense-1012,128,8957.748357676986,0.0,1187909632,1187909632,0
add-1011,128,6222.472526204886,0.0,1187917824,1187917824,0
add-1010,128,6236.373047222244,0.0,1187917824,1187917824,0
split-1009,64,6340.485100844159,0.0,1187917824,1187917824,0
sigmoid-1007,64,6237.587440381559,0.0,1187917824,1187917824,0
sigmoid-1022,64,6247.431613636079,0.0,1187917824,1187917824,0
sigmoid-1025,64,6246.280539825879,0.0,1187917824,1187917824,0
tanh-1027,64,6204.140831250863,0.0,1187917824,1187917824,0
multiply-1021,128,6240.506027250402,0.0,1187917824,1187917824,0
multiply-1024,128,6237.92339841557,0.0,1187917824,1187917824,0
add-1020,128,6244.7606819512075,0.0,1187917824,1187917824,0
tanh-1019,64,6217.876978805396,0.0,1187917824,1187917824,0
multiply-1006,128,6249.193693380599,0.0,1187917824,1187917824,0
tuple-1037,128,5.328954386500433,0.0,1187917824,1187917824,0
concatenate-1036,128,6249.851551015323,0.0,1187917824,1187917824,0
nn.dense-1035,128,8725.172601180002,0.0,1187917824,1187917824,0
add-1034,128,6232.79719731297,0.0,1187921920,1187917824,4096
add-1033,128,6236.129089257493,0.0,1187921920,1187921920,0
split-1032,64,6331.743928289283,0.0,1187921920,1187921920,0
sigmoid-1030,64,6235.695743570977,0.0,1187921920,1187921920,0
sigmoid-1045,64,6254.805615901316,0.0,1187921920,1187921920,0
sigmoid-1048,64,6247.179085848374,0.0,1187926016,1187921920,4096
tanh-1050,64,6213.248106993352,0.0,1187926016,1187926016,0
multiply-1044,128,6244.996460204469,0.0,1187930112,1187930112,0
multiply-1047,128,6286.669912865197,0.0,1187930112,1187930112,0
add-1043,128,6345.332509610105,0.0,1187930112,1187930112,0
tanh-1042,64,6225.766677449053,0.0,1187930112,1187930112,0
multiply-1029,128,6248.054057810968,0.0,1187930112,1187930112,0
tuple-1060,128,5.3637351292050015,0.0,1187930112,1187930112,0
concatenate-1059,128,6214.290318614266,0.0,1187938304,1187938304,0
nn.dense-1058,128,8773.403556276086,0.0,1187938304,1187938304,0
add-1057,128,6245.788780111103,0.0,1187938304,1187938304,0
add-1056,128,6241.599057603371,0.0,1187938304,1187938304,0
split-1055,64,6335.007555370746,0.0,1187946496,1187942400,4096
sigmoid-1053,64,6241.319258843346,0.0,1187946496,1187946496,0
sigmoid-1068,64,6287.689507922436,0.0,1187946496,1187946496,0
sigmoid-1071,64,6315.778815098911,0.0,1187946496,1187946496,0
tanh-1073,64,6196.586745925215,0.0,1187946496,1187946496,0
multiply-1067,128,6254.736111631625,0.0,1187950592,1187946496,4096
multiply-1070,128,6253.913629723958,0.0,1187950592,1187950592,0
add-1066,128,6236.273029161003,0.0,1187954688,1187954688,0
tanh-1065,64,6205.23615431326,0.0,1187958784,1187954688,4096
multiply-1052,128,6236.604974578805,0.0,1187958784,1187958784,0
tuple-1083,128,5.334346752413298,0.0,1187958784,1187958784,0
concatenate-1082,128,6225.307978678399,0.0,1187962880,1187962880,0
nn.dense-1081,128,8675.217137326745,0.0,1187962880,1187962880,0
add-1080,128,6251.991421871143,0.0,1187962880,1187962880,0
add-1079,128,6230.559037909925,0.0,1187962880,1187962880,0
split-1078,64,6331.163001698749,0.0,1187962880,1187962880,0
sigmoid-1076,64,6258.95334617116,0.0,1187962880,1187962880,0
sigmoid-1091,64,6240.4201540703725,0.0,1187962880,1187962880,0
sigmoid-1094,64,6253.754384211841,0.0,1187962880,1187962880,0
tanh-1096,64,6238.763727079956,0.0,1187962880,1187962880,0
multiply-1090,128,6243.080037940714,0.0,1187962880,1187962880,0
multiply-1093,128,6278.392300595905,0.0,1187962880,1187962880,0
add-1089,128,6215.220798194285,0.0,1187962880,1187962880,0
tanh-1088,64,6206.895522573126,0.0,1187962880,1187962880,0
multiply-1075,128,6221.0378500665,0.0,1187962880,1187962880,0
tuple-1106,128,5.332776273383415,0.0,1187962880,1187962880,0
concatenate-1105,128,6201.725819080664,0.0,1187966976,1187962880,4096
nn.dense-1104,128,8812.52116442673,0.0,1187983360,1187995648,0
add-1103,128,6369.279924599434,0.0,1187999744,1187999744,0
add-1102,128,6227.7142732778675,0.0,1187999744,1187999744,0
split-1101,64,6353.163160361227,0.0,1187999744,1187999744,0
sigmoid-1099,64,6217.939172326451,0.0,1188003840,1187999744,4096
sigmoid-1114,64,6225.146884586246,0.0,1188007936,1188007936,0
sigmoid-1117,64,6220.077195303965,0.0,1188007936,1188007936,0
tanh-1119,64,6198.533536321216,0.0,1188012032,1188007936,4096
multiply-1113,128,6218.522603191186,0.0,1188012032,1188012032,0
multiply-1116,128,6214.218893665665,0.0,1188020224,1188012032,8192
add-1112,128,6224.35784758885,0.0,1188020224,1188020224,0
tanh-1111,64,6213.167491171515,0.0,1188020224,1188020224,0
multiply-1098,128,6217.154870249662,0.0,1188020224,1188020224,0
tuple-1129,128,5.192200902176983,0.0,1188020224,1188020224,0
concatenate-1128,128,6209.548421509645,0.0,1188028416,1188028416,0
nn.dense-1127,128,8739.45718478606,0.0,1188032512,1188032512,0
add-1126,128,6212.3530865545035,0.0,1188040704,1188040704,0
add-1125,128,6212.381659247142,0.0,1188040704,1188040704,0
split-1124,64,6334.165774859904,0.0,1188044800,1188040704,4096
sigmoid-1122,64,6225.325568662585,0.0,1188044800,1188044800,0
sigmoid-1137,64,6222.337720115821,0.0,1188044800,1188044800,0
sigmoid-1140,64,6234.570877449659,0.0,1188044800,1188044800,0
tanh-1142,64,6204.059839567262,0.0,1188044800,1188044800,0
multiply-1136,128,6239.547283576883,0.0,1188044800,1188044800,0
multiply-1139,128,6246.16582540085,0.0,1188044800,1188044800,0
add-1135,128,6228.278223449374,0.0,1188044800,1188044800,0
tanh-1134,64,6204.406946632343,0.0,1188044800,1188044800,0
multiply-1121,128,6224.046729908992,0.0,1188044800,1188044800,0
tuple-1152,128,5.144611133687967,0.0,1188044800,1188044800,0
concatenate-1151,128,6206.425460700958,0.0,1188044800,1188044800,0
nn.dense-1150,128,8934.069725464578,0.0,1188044800,1188044800,0
add-1149,128,6410.223415819425,0.0,1188044800,1188044800,0
add-1148,128,6217.9152911988485,0.0,1188044800,1188044800,0
split-1147,64,6316.709934259504,0.0,1188044800,1188044800,0
sigmoid-1145,64,6227.336191186534,0.0,1188044800,1188044800,0
sigmoid-1160,64,6223.172437961151,0.0,1188048896,1188044800,4096
sigmoid-1163,64,6218.083503206881,0.0,1188048896,1188048896,0
tanh-1165,64,6190.8919303542925,0.0,1188048896,1188048896,0
multiply-1159,128,6220.802313432836,0.0,1188048896,1188048896,0
multiply-1162,128,6213.749686362676,0.0,1188048896,1188048896,0
add-1158,128,6224.938601565814,0.0,1188048896,1188048896,0
tanh-1157,64,6187.637790275067,0.0,1188048896,1188048896,0
multiply-1144,128,6231.968254212274,0.0,1188048896,1188048896,0
tuple-1175,128,5.387509778856227,0.0,1188048896,1188048896,0
concatenate-1174,128,6203.571486983781,0.0,1188048896,1188048896,0
nn.dense-1173,128,8664.820142029335,0.0,1188048896,1188048896,0
add-1172,128,6402.491830427892,0.0,1188061184,1188057088,4096
add-1171,128,6411.007980428948,0.0,1188061184,1188061184,0
split-1170,64,6317.657496178963,0.0,1188061184,1188061184,0
sigmoid-1168,64,6227.209413122956,0.0,1188065280,1188061184,4096
sigmoid-1183,64,6229.015075260695,0.0,1188065280,1188065280,0
sigmoid-1186,64,6222.468254953569,0.0,1188069376,1188069376,0
tanh-1188,64,6195.635245082207,0.0,1188069376,1188069376,0
multiply-1182,128,6237.221164376742,0.0,1188069376,1188069376,0
multiply-1185,128,6233.4362064024135,0.0,1188077568,1188077568,0
add-1181,128,6221.525984276221,0.0,1188077568,1188077568,0
tanh-1180,64,6202.195578125968,0.0,1188077568,1188077568,0
expand_dims-1739,64,7.053644941800129,0.0,1188077568,1188077568,0
multiply-1167,128,6218.090007826768,0.0,1188077568,1188077568,0
tuple-57,640,12.27108919715855,0.0,1188077568,1188077568,0
expand_dims-1731,64,6.995344789420403,0.0,1188089856,1188085760,4096
stack-56,640,6795.566177829293,0.0,1188089856,1188089856,0
expand_dims-55,64,6.873777533430974,0.0,1189249024,1186570240,2678784
squeeze-54,64,6.8259166379583,0.0,1189249024,1189249024,0
split-53,64,6409.9074629521365,0.0,1189253120,1189249024,4096
squeeze-51,64,6.949063469603091,0.0,1189257216,1189257216,0
squeeze-1260,64,7.10869771128479,0.0,1189257216,1189257216,0
squeeze-1283,64,7.102286746400525,0.0,1189257216,1189257216,0
squeeze-1306,64,7.042687821914158,0.0,1189257216,1189257216,0
squeeze-1329,64,7.16461894411768,0.0,1189257216,1189257216,0
squeeze-1352,64,6.862100909367031,0.0,1189257216,1189257216,0
squeeze-1375,64,6.872381213846919,0.0,1189257216,1189257216,0
squeeze-1398,64,6.815543317060364,0.0,1189257216,1189257216,0
squeeze-1421,64,6.928533247995483,0.0,1189257216,1189257216,0
squeeze-1444,64,7.052816314049111,0.0,1189257216,1189257216,0
tuple-50,128,5.2501972723677115,0.0,1189257216,1189257216,0
concatenate-49,128,6215.998061582048,0.0,1189257216,1189257216,0
nn.dense-48,128,8542.344872099738,0.0,1189257216,1189257216,0
add-47,128,6225.361275632093,0.0,1189257216,1189257216,0
add-46,128,6217.343198735007,0.0,1189261312,1189257216,4096
split-45,64,6314.129221606496,0.0,1189265408,1189261312,4096
sigmoid-43,64,6223.78519323895,0.0,1189265408,1189265408,0
sigmoid-1240,64,6227.0680357555675,0.0,1189265408,1189265408,0
sigmoid-1247,64,6231.493423422305,0.0,1189265408,1189265408,0
tanh-1249,64,6210.927550426984,0.0,1189265408,1189265408,0
multiply-1239,128,6218.834265195567,0.0,1189269504,1189265408,4096
multiply-1246,128,6228.908679151372,0.0,1189269504,1189269504,0
add-1238,128,6214.165497061521,0.0,1189273600,1189269504,4096
tanh-1237,64,6196.7846735224875,0.0,1189273600,1189273600,0
multiply-42,128,6227.842832985179,0.0,1189273600,1189273600,0
tuple-1259,128,5.174957847888667,0.0,1189273600,1189273600,0
concatenate-1258,128,6229.770458858993,0.0,1189277696,1189277696,0
nn.dense-1257,128,8673.327017922407,0.0,1189281792,1189281792,0
add-1256,128,6218.170230111364,0.0,1189281792,1189281792,0
add-1255,128,6213.212438629252,0.0,1189281792,1189281792,0
split-1254,64,6354.652553414883,0.0,1189285888,1189281792,4096
sigmoid-1252,64,6224.86424725977,0.0,1189285888,1189285888,0
sigmoid-1267,64,6223.538516525749,0.0,1189285888,1189285888,0
sigmoid-1270,64,6235.049429752169,0.0,1189289984,1189285888,4096
tanh-1272,64,6183.453106841728,0.0,1189294080,1189289984,4096
multiply-1266,128,6206.975801116871,0.0,1189294080,1189294080,0
multiply-1269,128,6216.007747212469,0.0,1189294080,1189294080,0
add-1265,128,6218.375823001814,0.0,1189298176,1189298176,0
tanh-1264,64,6199.128768448697,0.0,1189302272,1189302272,0
multiply-1251,128,6233.877284053156,0.0,1189302272,1189302272,0
tuple-1282,128,5.217942124472909,0.0,1189302272,1189302272,0
concatenate-1281,128,6216.019084116026,0.0,1189306368,1189302272,4096
nn.dense-1280,128,8850.017776617047,0.0,1189314560,1189310464,4096
add-1279,128,6410.7550842570645,0.0,1189318656,1189318656,0
add-1278,128,6413.358383348232,0.0,1189318656,1189318656,0
split-1277,64,6346.870812668857,0.0,1189326848,1189318656,8192
sigmoid-1275,64,6235.764795675978,0.0,1189326848,1189326848,0
sigmoid-1290,64,6213.915683032797,0.0,1189326848,1189326848,0
sigmoid-1293,64,6219.935826350729,0.0,1189326848,1189326848,0
tanh-1295,64,6227.372767469011,0.0,1189326848,1189326848,0
multiply-1289,128,6218.107827059262,0.0,1189326848,1189326848,0
multiply-1292,128,6223.987809727366,0.0,1189330944,1189330944,0
add-1288,128,6233.451148248781,0.0,1189335040,1189330944,4096
tanh-1287,64,6199.141242448251,0.0,1189335040,1189335040,0
multiply-1274,128,6204.622768303373,0.0,1189339136,1189335040,4096
tuple-1305,128,5.182373790910576,0.0,1189339136,1189339136,0
concatenate-1304,128,6191.8919765311675,0.0,1189343232,1189343232,0
nn.dense-1303,128,8783.914996101534,0.0,1189347328,1189343232,4096
add-1302,128,6189.592934300315,0.0,1189355520,1189351424,4096
add-1301,128,6206.12127001665,0.0,1189359616,1189355520,4096
split-1300,64,6299.709004355312,0.0,1189359616,1189359616,0
sigmoid-1298,64,6246.966049420945,0.0,1189363712,1189359616,4096
sigmoid-1313,64,6211.335409506558,0.0,1189363712,1189363712,0
sigmoid-1316,64,6202.4240355672955,0.0,1189367808,1189367808,0
tanh-1318,64,6199.291214166306,0.0,1189367808,1189367808,0
multiply-1312,128,6206.583629264093,0.0,1189371904,1189367808,4096
multiply-1315,128,6211.222658863519,0.0,1189371904,1189371904,0
add-1311,128,6214.945498121817,0.0,1189376000,1189376000,0
tanh-1310,64,6206.762062651557,0.0,1189380096,1189376000,4096
multiply-1297,128,6212.719485028653,0.0,1189384192,1189380096,4096
tuple-1328,128,5.186089361090635,0.0,1189384192,1189384192,0
concatenate-1327,128,6189.916118525077,0.0,1189384192,1189384192,0
nn.dense-1326,128,8877.477798699076,0.0,1189392384,1189384192,8192
add-1325,128,6315.083515094042,0.0,1189384192,1189384192,0
add-1324,128,6204.681777061775,0.0,1189384192,1189384192,0
split-1323,64,6301.5011089071795,0.0,1189384192,1189384192,0
sigmoid-1321,64,6209.694906935189,0.0,1189384192,1189384192,0
sigmoid-1336,64,6213.462036460377,0.0,1189384192,1189384192,0
sigmoid-1339,64,6218.242422379815,0.0,1189384192,1189384192,0
tanh-1341,64,6187.6543310288735,0.0,1189384192,1189384192,0
multiply-1335,128,6214.59692685925,0.0,1189384192,1189384192,0
multiply-1338,128,6228.503172794062,0.0,1189384192,1189384192,0
add-1334,128,6208.691031796245,0.0,1189384192,1189384192,0
tanh-1333,64,6190.060019743337,0.0,1189384192,1189384192,0
multiply-1320,128,6215.382989031193,0.0,1189384192,1189384192,0
tuple-1351,128,5.313563130756941,0.0,1189384192,1189384192,0
concatenate-1350,128,6205.958103384843,0.0,1189384192,1189384192,0
nn.dense-1349,128,8681.087636174996,0.0,1189384192,1189384192,0
add-1348,128,6220.377985565118,0.0,1189384192,1189384192,0
add-1347,128,6212.397871262038,0.0,1189384192,1189384192,0
split-1346,64,6354.268051263549,0.0,1189384192,1189384192,0
sigmoid-1344,64,6211.063260620859,0.0,1189384192,1189384192,0
sigmoid-1359,64,6238.481599024257,0.0,1189384192,1189384192,0
sigmoid-1362,64,6230.246102782128,0.0,1189384192,1189384192,0
tanh-1364,64,6210.873103926498,0.0,1189384192,1189384192,0
multiply-1358,128,6226.738207456501,0.0,1189384192,1189384192,0
multiply-1361,128,6226.688256518588,0.0,1189384192,1189384192,0
add-1357,128,6224.1645327538035,0.0,1189384192,1189384192,0
tanh-1356,64,6223.333021770456,0.0,1189384192,1189384192,0
multiply-1343,128,6222.21162208257,0.0,1189384192,1189384192,0
tuple-1374,128,5.226983677190488,0.0,1189384192,1189384192,0
concatenate-1373,128,6203.386698410261,0.0,1189384192,1189384192,0
nn.dense-1372,128,8921.48776056181,0.0,1189396480,1189384192,12288
add-1371,128,6387.322021568502,0.0,1189384192,1189384192,0
add-1370,128,6339.150629766766,0.0,1189384192,1189384192,0
split-1369,64,6342.009942212848,0.0,1189384192,1189384192,0
sigmoid-1367,64,6225.307264239029,0.0,1189384192,1189384192,0
sigmoid-1382,64,6226.5274837933885,0.0,1189384192,1189384192,0
sigmoid-1385,64,6245.896102111929,0.0,1189388288,1189384192,4096
tanh-1387,64,6214.353768195142,0.0,1189384192,1189384192,0
multiply-1381,128,6223.130428837787,0.0,1189396480,1189384192,12288
multiply-1384,128,6226.743635684957,0.0,1189416960,1189416960,0
add-1380,128,6215.612969724064,0.0,1189421056,1189416960,4096
tanh-1379,64,6204.252600205866,0.0,1189425152,1189421056,4096
multiply-1366,128,6219.391030263844,0.0,1189425152,1189425152,0
tuple-1397,128,5.2154363714806244,0.0,1189425152,1189425152,0
concatenate-1396,128,6211.1372283621,0.0,1189429248,1189429248,0
nn.dense-1395,128,8806.286882226002,0.0,1189429248,1189429248,0
add-1394,128,6406.055152042146,0.0,1189429248,1189429248,0
add-1393,128,6409.370940039478,0.0,1189429248,1189429248,0
split-1392,64,6325.207344039143,0.0,1189433344,1189429248,4096
sigmoid-1390,64,6253.8584387059955,0.0,1189433344,1189433344,0
sigmoid-1405,64,6216.009502178547,0.0,1189433344,1189433344,0
sigmoid-1408,64,6233.91287262977,0.0,1189433344,1189433344,0
tanh-1410,64,6202.9897233103575,0.0,1189433344,1189433344,0
multiply-1404,128,6227.763748316337,0.0,1189433344,1189433344,0
multiply-1407,128,6219.209824556002,0.0,1189433344,1189433344,0
add-1403,128,6232.955884181984,0.0,1189433344,1189433344,0
tanh-1402,64,6215.328741521858,0.0,1189437440,1189437440,0
multiply-1389,128,6230.047381142231,0.0,1189437440,1189437440,0
tuple-1420,128,5.217901807589224,0.0,1189437440,1189437440,0
concatenate-1419,128,6232.668658392162,0.0,1189441536,1189441536,0
nn.dense-1418,128,8652.054632361822,0.0,1189441536,1189441536,0
add-1417,128,6405.510190992019,0.0,1189441536,1189441536,0
add-1416,128,6398.083845573858,0.0,1189441536,1189441536,0
split-1415,64,6339.641458354417,0.0,1189445632,1189441536,4096
sigmoid-1413,64,6226.802686571768,0.0,1189445632,1189445632,0
sigmoid-1428,64,6224.869472841483,0.0,1189445632,1189445632,0
sigmoid-1431,64,6237.53643959109,0.0,1189445632,1189445632,0
tanh-1433,64,6182.357097849974,0.0,1189445632,1189445632,0
multiply-1427,128,6265.33438752895,0.0,1189453824,1189453824,0
multiply-1430,128,6221.132616042142,0.0,1189453824,1189453824,0
add-1426,128,6224.579489219904,0.0,1189453824,1189453824,0
tanh-1425,64,6190.913723839767,0.0,1189453824,1189453824,0
multiply-1412,128,6211.372493014592,0.0,1189453824,1189453824,0
tuple-1443,128,5.140713694676549,0.0,1189457920,1189457920,0
concatenate-1442,128,6218.2346661032325,0.0,1189462016,1189462016,0
nn.dense-1441,128,8882.778596261747,0.0,1189462016,1189462016,0
add-1440,128,6403.484865549767,0.0,1189462016,1189462016,0
add-1439,128,6404.3841526627675,0.0,1189462016,1189462016,0
split-1438,64,6316.030755169478,0.0,1189470208,1189466112,4096
sigmoid-1436,64,6232.990494320231,0.0,1189470208,1189470208,0
sigmoid-1451,64,6237.412529715046,0.0,1189470208,1189470208,0
sigmoid-1454,64,6238.82779087021,0.0,1189474304,1189470208,4096
tanh-1456,64,6199.79567826238,0.0,1189474304,1189474304,0
multiply-1450,128,6214.319513922025,0.0,1189478400,1189474304,4096
multiply-1453,128,6221.096316470178,0.0,1189478400,1189478400,0
add-1449,128,6227.370308123249,0.0,1189478400,1189478400,0
tanh-1448,64,6172.894477634048,0.0,1189478400,1189478400,0
expand_dims-1740,64,6.927289648733353,0.0,1189478400,1189478400,0
multiply-1435,128,6222.909703607849,0.0,1189482496,1189482496,0
tuple-41,640,12.024514181209558,0.0,1189486592,1189486592,0
expand_dims-1732,64,6.81028723009155,0.0,1189490688,1189490688,0
stack-40,640,6749.818486673553,0.0,1189490688,1189490688,0
expand_dims-39,64,6.991765043981979,0.0,1189900288,1189900288,0
squeeze-38,64,6.923197141048349,0.0,1189453824,1189449728,4096
split-37,64,6372.044854631933,0.0,1189457920,1189457920,0
squeeze-35,64,6.994078010914779,0.0,1189462016,1189462016,0
squeeze-1528,64,6.984524008535811,0.0,1189462016,1189462016,0
squeeze-1551,64,6.829549056453723,0.0,1189462016,1189462016,0
squeeze-1574,64,7.0475698472777335,0.0,1189466112,1189466112,0
squeeze-1597,64,6.841326879111134,0.0,1189466112,1189466112,0
squeeze-1620,64,7.02020299991961,0.0,1189466112,1189466112,0
squeeze-1643,64,6.92744149850993,0.0,1189470208,1189470208,0
squeeze-1666,64,7.142838359965998,0.0,1189470208,1189470208,0
squeeze-1689,64,6.979093007846361,0.0,1189474304,1189470208,4096
squeeze-1712,64,7.091161288651504,0.0,1189482496,1189478400,4096
tuple-34,128,5.454061037778633,0.0,1189482496,1189482496,0
concatenate-33,128,6201.599930608048,0.0,1189486592,1189482496,4096
nn.dense-32,128,8909.498700091252,0.0,1189486592,1189486592,0
add-31,128,6207.464780839794,0.0,1189494784,1189494784,0
add-30,128,6220.326204940025,0.0,1189502976,1189494784,8192
split-29,64,6315.029529086308,0.0,1189502976,1189502976,0
sigmoid-27,64,6230.378917910448,0.0,1189507072,1189507072,0
sigmoid-1508,64,6224.113791132319,0.0,1189507072,1189507072,0
sigmoid-1515,64,6260.768537898042,0.0,1189511168,1189507072,4096
tanh-1517,64,6217.26784340966,0.0,1189511168,1189511168,0
multiply-1507,128,6208.462191511879,0.0,1189511168,1189511168,0
multiply-1514,128,6213.877375363291,0.0,1189515264,1189515264,0
add-1506,128,6258.300956384395,0.0,1189523456,1189519360,4096
tanh-1505,64,6209.616959753783,0.0,1189523456,1189523456,0
multiply-26,128,6223.46205822414,0.0,1189527552,1189523456,4096
tuple-1527,128,5.322174170456571,0.0,1189527552,1189527552,0
concatenate-1526,128,6204.867887540633,0.0,1189531648,1189531648,0
nn.dense-1525,128,8765.853610144315,0.0,1189531648,1189531648,0
add-1524,128,6410.960700144797,0.0,1189539840,1189539840,0
add-1523,128,6219.234640067658,0.0,1189539840,1189539840,0
split-1522,64,6313.022060122668,0.0,1189539840,1189539840,0
sigmoid-1520,64,6228.67415998583,0.0,1189539840,1189539840,0
sigmoid-1535,64,6236.940916799681,0.0,1189539840,1189539840,0
sigmoid-1538,64,6229.331317494601,0.0,1189539840,1189539840,0
tanh-1540,64,6207.626895490532,0.0,1189539840,1189539840,0
multiply-1534,128,6220.282707819119,0.0,1189539840,1189539840,0
multiply-1537,128,6234.026182831827,0.0,1189539840,1189539840,0
add-1533,128,6215.424236369924,0.0,1189539840,1189539840,0
tanh-1532,64,6195.262956989247,0.0,1189539840,1189539840,0
multiply-1519,128,6216.474095711622,0.0,1189539840,1189539840,0
tuple-1550,128,5.219310192980964,0.0,1189539840,1189539840,0
concatenate-1549,128,6234.070902733045,0.0,1189539840,1189539840,0
nn.dense-1548,128,8906.24600497159,0.0,1189539840,1189539840,0
add-1547,128,6401.924524196541,0.0,1189539840,1189539840,0
add-1546,128,6409.2752668925405,0.0,1189539840,1189539840,0
split-1545,64,6530.633346229487,0.0,1189539840,1189539840,0
sigmoid-1543,64,6425.353134381975,0.0,1189539840,1189539840,0
sigmoid-1558,64,6424.538206790321,0.0,1189539840,1189539840,0
sigmoid-1561,64,6430.581413088389,0.0,1189539840,1189539840,0
tanh-1563,64,6400.427418971769,0.0,1189539840,1189539840,0
multiply-1557,128,6425.815867692405,0.0,1189539840,1189539840,0
multiply-1560,128,6326.328469937539,0.0,1189539840,1189539840,0
add-1556,128,6214.168325526933,0.0,1189539840,1189539840,0
tanh-1555,64,6197.440582113378,0.0,1189543936,1189543936,0
multiply-1542,128,6220.180899029923,0.0,1189543936,1189543936,0
tuple-1573,128,5.289101239261385,0.0,1189543936,1189543936,0
concatenate-1572,128,6206.712197480658,0.0,1189543936,1189543936,0
nn.dense-1571,128,8915.347438462206,0.0,1189552128,1189552128,0
add-1570,128,6225.820294262194,0.0,1189552128,1189552128,0
add-1569,128,6192.622867190015,0.0,1189552128,1189552128,0
split-1568,64,6344.113031385019,0.0,1189552128,1189552128,0
sigmoid-1566,64,6239.142439431913,0.0,1189552128,1189552128,0
sigmoid-1581,64,6243.413345261599,0.0,1189552128,1189552128,0
sigmoid-1584,64,6220.937707915581,0.0,1189552128,1189552128,0
tanh-1586,64,6201.028668815073,0.0,1189556224,1189552128,4096
multiply-1580,128,6218.230335265092,0.0,1189556224,1189556224,0
multiply-1583,128,6248.497946024001,0.0,1189560320,1189560320,0
add-1579,128,6224.107709480006,0.0,1189560320,1189560320,0
tanh-1578,64,6199.359715351905,0.0,1189564416,1189564416,0
multiply-1565,128,6234.7353704738825,0.0,1189568512,1189568512,0
tuple-1596,128,5.17911029572448,0.0,1189568512,1189568512,0
concatenate-1595,128,6208.732429513203,0.0,1189572608,1189572608,0
nn.dense-1594,128,8866.19624916276,0.0,1189572608,1189572608,0
add-1593,128,6414.908411788785,0.0,1189572608,1189572608,0
add-1592,128,6399.6157194648695,0.0,1189576704,1189572608,4096
split-1591,64,6548.609172104458,0.0,1189584896,1189580800,4096
sigmoid-1589,64,6220.0263954864795,0.0,1189584896,1189584896,0
sigmoid-1604,64,6236.3406630686195,0.0,1189584896,1189584896,0
sigmoid-1607,64,6229.793222321785,0.0,1189584896,1189584896,0
tanh-1609,64,6232.885696183662,0.0,1189584896,1189584896,0
multiply-1603,128,6237.916742362969,0.0,1189584896,1189584896,0
multiply-1606,128,6256.508633909759,0.0,1189584896,1189584896,0
add-1602,128,6238.131679246693,0.0,1189584896,1189584896,0
tanh-1601,64,6181.552920113594,0.0,1189584896,1189584896,0
multiply-1588,128,6215.938362181909,0.0,1189584896,1189584896,0
tuple-1619,128,5.229038755220283,0.0,1189588992,1189588992,0
concatenate-1618,128,6218.338416298576,0.0,1189593088,1189593088,0
nn.dense-1617,128,8756.283352603152,0.0,1189593088,1189593088,0
add-1616,128,6399.289336401996,0.0,1189593088,1189593088,0
add-1615,128,6410.406146275198,0.0,1189593088,1189593088,0
split-1614,64,6363.678370928585,0.0,1189593088,1189593088,0
sigmoid-1612,64,6250.14728798322,0.0,1189593088,1189593088,0
sigmoid-1627,64,6241.719480292989,0.0,1189593088,1189593088,0
sigmoid-1630,64,6251.678213309025,0.0,1189593088,1189593088,0
tanh-1632,64,6211.987587508068,0.0,1189593088,1189593088,0
multiply-1626,128,6230.054510623476,0.0,1189593088,1189593088,0
multiply-1629,128,6236.558553844621,0.0,1189597184,1189597184,0
add-1625,128,6239.159355015303,0.0,1189597184,1189597184,0
tanh-1624,64,6220.69838663532,0.0,1189597184,1189597184,0
multiply-1611,128,6343.4996257578405,0.0,1189597184,1189597184,0
tuple-1642,128,5.124386271466327,0.0,1189601280,1189601280,0
concatenate-1641,128,6238.91895207017,0.0,1189605376,1189601280,4096
nn.dense-1640,128,8852.507805325988,0.0,1189605376,1189605376,0
add-1639,128,6416.235778294587,0.0,1189605376,1189605376,0
add-1638,128,6230.2630557557795,0.0,1189605376,1189605376,0
split-1637,64,6328.845847855736,0.0,1189605376,1189605376,0
sigmoid-1635,64,6247.3249133960335,0.0,1189605376,1189605376,0
sigmoid-1650,64,6255.270403833674,0.0,1189605376,1189605376,0
sigmoid-1653,64,6252.018992485528,0.0,1189605376,1189605376,0
tanh-1655,64,6226.470661999462,0.0,1189605376,1189605376,0
multiply-1649,128,6250.513832165561,0.0,1189605376,1189605376,0
multiply-1652,128,6238.495694972276,0.0,1189609472,1189605376,4096
add-1648,128,6227.868778562268,0.0,1189609472,1189605376,4096
tanh-1647,64,6223.932966541143,0.0,1189605376,1189605376,0
multiply-1634,128,6233.8299229379345,0.0,1189605376,1189609472,0
tuple-1665,128,5.212223026128576,0.0,1189605376,1189605376,0
concatenate-1664,128,6233.959412124007,0.0,1189646336,1189638144,8192
nn.dense-1663,128,8813.210334674819,0.0,1189646336,1189638144,8192
add-1662,128,6404.7287013003615,0.0,1189650432,1189650432,0
add-1661,128,6418.343997843998,0.0,1189650432,1189650432,0
split-1660,64,6554.780234615637,0.0,1189650432,1189650432,0
sigmoid-1658,64,6240.928142187414,0.0,1189650432,1189650432,0
sigmoid-1673,64,6241.839642534391,0.0,1189654528,1189650432,4096
sigmoid-1676,64,6247.328877005349,0.0,1189654528,1189654528,0
tanh-1678,64,6211.398733627164,0.0,1189654528,1189654528,0
multiply-1672,128,6246.2340157601975,0.0,1189654528,1189654528,0
multiply-1675,128,6239.919091713506,0.0,1189658624,1189654528,4096
add-1671,128,6230.996850962138,0.0,1189662720,1189662720,0
tanh-1670,64,6219.974458997942,0.0,1189666816,1189662720,4096
multiply-1657,128,6253.031613852253,0.0,1189666816,1189666816,0
tuple-1688,128,5.340884588277871,0.0,1189666816,1189666816,0
concatenate-1687,128,6236.413827068139,0.0,1189675008,1189670912,4096
nn.dense-1686,128,9043.022009654926,0.0,1189675008,1189675008,0
add-1685,128,6426.261255010793,0.0,1189691392,1189691392,0
add-1684,128,6438.402027808476,0.0,1189691392,1189691392,0
split-1683,64,6569.177712740827,0.0,1189691392,1189691392,0
sigmoid-1681,64,6436.7844478444795,0.0,1189691392,1189691392,0
sigmoid-1696,64,6452.021712252825,0.0,1189695488,1189695488,0
sigmoid-1699,64,6457.638680292123,0.0,1189699584,1189699584,0
tanh-1701,64,6421.252937577959,0.0,1189703680,1189699584,4096
multiply-1695,128,6449.70992277843,0.0,1189703680,1189703680,0
multiply-1698,128,6446.9673426762765,0.0,1189707776,1189703680,4096
add-1694,128,6229.840236881881,0.0,1189707776,1189707776,0
tanh-1693,64,6202.820545734051,0.0,1189711872,1189711872,0
multiply-1680,128,6261.500062551605,0.0,1189711872,1189711872,0
tuple-1711,128,5.167367147195191,0.0,1189711872,1189711872,0
concatenate-1710,128,6230.272083034523,0.0,1189720064,1189715968,4096
nn.dense-1709,128,8982.210340348141,0.0,1189724160,1189720064,4096
add-1708,128,6417.461872632952,0.0,1189732352,1189728256,4096
add-1707,128,6416.688372130089,0.0,1189732352,1189732352,0
split-1706,64,6369.957396765663,0.0,1189732352,1189732352,0
sigmoid-1704,64,6246.733341645886,0.0,1189732352,1189732352,0
sigmoid-1719,64,6267.653643876785,0.0,1189732352,1189732352,0
sigmoid-1722,64,6253.527743640874,0.0,1189732352,1189732352,0
tanh-1724,64,6216.565828635592,0.0,1189732352,1189732352,0
multiply-1718,128,6231.527055901387,0.0,1189732352,1189732352,0
multiply-1721,128,6241.006763561312,0.0,1189732352,1189732352,0
add-1717,128,6246.998788771789,0.0,1189732352,1189732352,0
tanh-1716,64,6229.945165711439,0.0,1189732352,1189732352,0
expand_dims-1741,64,7.249265576721217,0.0,1189732352,1189732352,0
multiply-1703,128,6261.855586714028,0.0,1189732352,1189732352,0
tuple-1735,384,9.568975428519591,0.0,1189732352,1189732352,0
tuple-25,640,12.685276976927462,0.0,1189732352,1189732352,0
expand_dims-1733,64,7.096366110381907,0.0,1189732352,1189732352,0
concatenate-1734,384,6276.6770475354315,0.0,1189732352,1189732352,0
stack-24,640,6697.9792303348395,0.0,1189732352,1189732352,0
tuple-1727,384,9.41287876048615,0.0,1189732352,1189732352,0
expand_dims-23,64,6.8524622163448985,0.0,1190227968,1187803136,2424832
concatenate-1726,384,6293.913873178626,0.0,1190227968,1190227968,0
squeeze-22,64,7.096999463809698,0.0,1190227968,1190227968,0
tuple-21,192,6.200972156582641,0.0,1190227968,1190227968,0
